PooledfundId,PooledFundName,AllocationSourceId,AllocationYear,ChfProjectCode,PlannedMen,PlannedWomen,PlannedBoys,PlannedGirls,PlannedTotal,ActualMen,ActualWomen,ActualBoys,ActualGirls,ActualTotal
23,Afghanistan,2,2014,AFG-14/S1/CCS/UN/213,75,0,0,0,75,75,0,0,0,75
23,Afghanistan,2,2014,AFG-14/S1/N/UN/223,380,80300,71352,68554,220586,2027,117506,37335,35871,192739
23,Afghanistan,2,2014,AFG-14/S1/H/INGO/225,21618,3081,10660,4790,40149,21484,3210,18201,5310,48205
23,Afghanistan,2,2014,AFG-14/S1/N/INGO/231,181,130,0,0,311,232,88,0,0,320
23,Afghanistan,2,2014,AFG-14/S1/N/INGO/234,210,36042,12560,12561,61373,639,46227,53232,52397,152495
23,Afghanistan,2,2014,AFG-14/S1/H/INGO/235,8555,8146,2005,2005,20711,9789,6765,1780,987,19321
23,Afghanistan,2,2014,AFG-14/S1/H/UN/236,160759,166477,41450,43141,411827,164343,170195,42359,44086,420983
23,Afghanistan,2,2014,AFG-14/S1/N/INGO/238,428,1401,2014,2014,5857,431,2125,1881,1887,6324
23,Afghanistan,2,2014,AFG-14/S1/N/INGO/240,342,9918,13193,13193,36646,336,20436,12623,17257,50652
23,Afghanistan,2,2014,AFG-14/S1/H/INGO/243,9693,1770,553,594,12610,35397,8667,3538,3067,50669
23,Afghanistan,2,2014,AFG-14/S1/N/INGO/247,20,6400,4674,4674,15768,26,16055,1346,1758,19185
23,Afghanistan,2,2014,AFG-14/S1/N/NGO/248,344,4063,6799,6799,18005,344,5230,9626,10869,26069
23,Afghanistan,2,2014,AFG-14/S1/H/INGO/250,17825,17125,17541,16853,69344,14473,30174,17370,36880,98897
23,Afghanistan,2,2014,AFG-14/S1/N/INGO/251,412,700,704,639,2455,442,279,1120,1108,2949
23,Afghanistan,2,2014,AFG-14/S1/H/UN/252,80,260178,0,0,260258,78,240070,0,0,240148
23,Afghanistan,2,2014,AFG-14/S1/H/NGO/254,12265,6285,998,998,20546,6011,2600,3009,2249,13869
23,Afghanistan,2,2014,AFG-14/SA2/N/INGO/264,102,8676,4974,5387,19139,10369,12011,9810,10545,42735
23,Afghanistan,2,2014,AFG-14/SA2/CCS/UN/269,2500,2500,0,0,5000,2456,2456,0,0,4912
23,Afghanistan,2,2014,AFG-14/SA2/N/UN/272,0,0,50380,48405,98785,0,0,53932,51817,105749
23,Afghanistan,2,2014,AFG-14/SA2/N/INGO/275,97699,97559,22843,22843,240944,129252,131559,25612,25612,312035
23,Afghanistan,2,2014,AFG-14/SA2/N/NGO/284,527,3238,14626,16905,35296,513,3431,15166,16365,35475
23,Afghanistan,2,2014,AFG-14/SA2/N/UN/287,86,4856,8538,8202,21682,105,4334,7522,7445,19406
23,Afghanistan,1,2014,AFG-14/ER/H/UN/288,12006,12497,3001,3124,30628,10878,11322,2719,2831,27750
23,Afghanistan,1,2014,AFG-14/ER/H/NGO/289,3144,3096,3438,3290,12968,4099,4324,4125,4010,16558
23,Afghanistan,1,2014,AFG-14/ER/H/INGO/291,4290,5712,2076,1770,13848,4285,6141,2180,1903,14509
23,Afghanistan,1,2014,AFG-14/ER/H/INGO/292,3794,3794,871,871,9330,2307,3281,1073,994,7655
23,Afghanistan,1,2014,AFG-14/ER/NFI/INGO/294,377,468,404,527,1776,306,380,328,429,1443
23,Afghanistan,1,2014,AFG-14/ER/NFI/INGO/296,5307,5307,3538,3538,17690,5307,5307,3538,3538,17690
23,Afghanistan,1,2014,AFG-14/ER/CCS/UN/298,1250,1250,0,0,2500,1011,1010,0,0,2021
23,Afghanistan,1,2014,AFG-14/ER/MS/INGO/301,7016,7016,12473,12473,38978,11383,11383,29674,29674,82114
23,Afghanistan,1,2014,AFG-14/ER/MS/INGO/303,2901,3215,3342,3342,12800,2178,2278,4112,4133,12701
23,Afghanistan,1,2014,AFG-14/ER/MS/UN/305,18900,18900,28350,28350,94500,32784,32784,49176,49176,163920
23,Afghanistan,1,2014,AFG-14/ER/MS/UN/306,7000,7000,28000,28000,70000,37754,36272,52137,50090,176253
23,Afghanistan,1,2014,AFG-14/ER/MS/UN/308,1130,959,1496,1275,4860,1021,1094,2045,1695,5855
23,Afghanistan,1,2015,AFG-15/O580/SRA/CCS/UN/312,40,40,0,0,80,20,20,0,0,40
23,Afghanistan,2,2015,AFG-15/O580/SA1/H/NGO/320,5681,2952,2099,2098,12830,10755,2690,3362,1865,18672
23,Afghanistan,2,2015,AFG-15/O580/SA1/MS/INGO/322,15223,15223,27062,27062,84570,16210,16210,28816,28816,90052
23,Afghanistan,2,2015,AFG-15/O580/SA1/MS/INGO/323,8492,8751,19118,18639,55000,10967,11300,24689,24071,71027
23,Afghanistan,2,2015,AFG-15/O580/SA1/H/INGO/325,4204,4376,1051,1094,10725,4376,2485,2056,1482,10399
23,Afghanistan,2,2015,AFG-15/O580/SA1/WASH/INGO/326,12202,8390,4840,2493,27925,20951,14100,10350,5982,51383
23,Afghanistan,2,2015,AFG-15/O580/SA1/N/INGO/327,115,45,0,0,160,189,71,0,0,260
23,Afghanistan,2,2015,AFG-15/O580/SA1/H/INGO/328,16104,3846,13928,4672,38550,17684,3940,15744,4460,41828
23,Afghanistan,2,2015,AFG-15/O580/SA1/WASH/INGO/330,3166,2923,2294,2117,10500,3166,2923,2294,2117,10500
23,Afghanistan,2,2015,AFG-15/O580/SA1/WASH/INGO/331,8097,8097,8097,8096,32387,8203,8203,8202,8202,32810
23,Afghanistan,2,2015,AFG-15/O580/SA1/H/UN/332,346649,360267,86546,90033,883495,374156,393343,86343,105531,959373
23,Afghanistan,2,2015,AFG-15/O580/SA1/H/INGO/338,37702,37702,9425,9425,94254,19491,45825,17561,17765,100642
23,Afghanistan,2,2015,AFG-15/O580/SA1/H/INGO/340,25391,27816,12573,11658,77438,51858,34158,21219,19661,126896
23,Afghanistan,2,2015,AFG-15/O580/SA1/H/INGO/342,64309,43996,10990,11101,130396,42762,44283,15322,15075,117442
23,Afghanistan,2,2015,AFG-15/O580/SA1/WASH/INGO/344,6449,8520,2610,2841,20420,4625,4103,4231,3027,15986
23,Afghanistan,2,2015,AFG-15/O580/SA1/H/INGO/350,12227,11617,3055,2903,29802,30325,31500,16268,14165,92258
23,Afghanistan,2,2015,AFG-15/O580/SA1/N/UN/352,0,0,22297,21423,43720,0,0,30730,29525,60255
23,Afghanistan,2,2015,AFG-15/O580/SA1/WASH/INGO/355,8288,7868,6064,5780,28000,6610,8556,6947,7651,29764
23,Afghanistan,2,2015,AFG-15/O580/SA1/N/UN/357,0,0,12291,11809,24100,0,0,12604,12109,24713
23,Afghanistan,2,2015,AFG-15/O580/SA1/MS/INGO/359,1656,1627,2944,2952,9179,1638,1738,2913,2888,9177
23,Afghanistan,2,2015,AFG-15/O580/SA1/WASH/UN/360,15683,15073,3643,3501,37900,16294,15660,3784,3638,39376
23,Afghanistan,2,2015,AFG-15/O580/SA1/MS/INGO/363,897,880,7704,6918,16399,602,547,8189,6335,15673
23,Afghanistan,2,2015,AFG-15/O580/SA1/N/INGO/364,27,747,20456,19294,40524,66,357,26563,28257,55243
23,Afghanistan,2,2015,AFG-15/O580/SA1/WASH/UN/366,24000,24000,26000,26000,100000,26833,26833,29070,29070,111806
23,Afghanistan,2,2015,AFG-15/O580/SA1/MS/UN/367,2156,2156,3832,3832,11976,3172,2934,5112,4533,15751
23,Afghanistan,2,2015,AFG-15/O580/SA1/MS/UN/372,13675,13675,20513,20513,68376,13675,13675,20513,20513,68376
23,Afghanistan,2,2015,AFG-15/O580/SA1/WASH/INGO/376,13782,13242,34456,33104,94584,18743,18742,19507,18008,75000
23,Afghanistan,2,2015,AFG-15/O580/SA1/MS/UN/381,6153,6153,24613,24613,61532,22454,21573,31007,29790,104824
23,Afghanistan,2,2015,AFG-15/3481/SA2/H/INGO/387,10482,10464,1759,1759,24464,9210,6807,4288,4002,24307
23,Afghanistan,2,2015,AFG-15/3481/SA2/H/NGO/398,1425,1390,273,276,3364,2954,1846,662,552,6014
23,Afghanistan,2,2015,AFG-15/3481/SA2/ESNFI/INGO/399,2298,2490,3750,4062,12600,1739,2221,2353,3249,9562
23,Afghanistan,2,2015,AFG-15/3481/SA2/N/UN/400,0,0,7543,7247,14790,0,0,7746,7442,15188
23,Afghanistan,2,2015,AFG-15/3481/SA2/WASH-FSAC/INGO/401,3423,3699,3959,4292,15373,3217,3224,843,918,8202
23,Afghanistan,2,2015,AFG-15/3481/SA2/H/INGO/402,13166,10768,3288,2690,29912,2563,440,199,91,3293
23,Afghanistan,2,2015,AFG-15/3481/SA2/APC/NGO/404,23460,24840,44160,45540,138000,23667,26892,57188,40796,148543
23,Afghanistan,2,2015,AFG-15/3481/SA2/WASH/INGO/405,6993,9303,3045,3934,23275,4935,5476,6158,6725,23294
23,Afghanistan,2,2015,AFG-15/3481/SA2/FSAC/INGO/406,3378,3245,4476,4301,15400,2324,2489,4956,4782,14551
23,Afghanistan,2,2015,AFG-15/3481/SA2/MS/INGO/410,9476,9821,2358,2455,24110,5563,6511,6171,5986,24231
23,Afghanistan,2,2015,AFG-15/3481/SA2/H/NGO/411,12721,13239,10407,10833,47200,10530,21699,12575,10360,55164
23,Afghanistan,2,2015,AFG-15/3481/SA2/APC-H/INGO/422,14900,14749,3753,4014,37416,5331,15389,5434,5062,31216
23,Afghanistan,2,2015,AFG-15/3481/SA2/WASH/INGO/425,1900,2000,1400,1700,7000,983,1059,2258,2433,6733
23,Afghanistan,2,2015,AFG-15/3481/SA2/N/UN/431,0,0,19421,18638,38059,0,0,19400,18639,38039
23,Afghanistan,2,2015,AFG-15/3481/SA2/ESNFI/INGO/432,2699,2699,4049,4049,13496,366,486,733,757,2342
23,Afghanistan,2,2015,AFG-15/3481/SA2/ESNFI/INGO/434,3150,3150,3850,3850,14000,2863,2980,3500,3642,12985
23,Afghanistan,2,2015,AFG-15/3481/SA2/FSAC/INGO/440,5985,5985,7315,7315,26600,5799,6036,7087,7377,26299
23,Afghanistan,2,2015,AFG-15/3481/SA2/APC/INGO/441,1200,1700,1250,1250,5400,2906,3028,2767,2411,11112
23,Afghanistan,2,2015,AFG-15/3481/SA2/MS/INGO/444,11375,11744,26669,28923,78711,10331,10667,24222,26274,71494
23,Afghanistan,2,2015,AFG-15/3481/SA2/MS/UN/450,1338,585,1715,544,4182,2183,506,2080,411,5180
23,Afghanistan,2,2015,AFG-15/3481/SA2/APC/INGO/451,233,193,1494,1513,3433,246,300,1580,1512,3638
23,Afghanistan,1,2015,AFG-15/3481/AFG/CCS/UN/454,1000,1000,0,0,2000,4149,4149,0,0,8298
23,Afghanistan,1,2015,AFG-15/3481/AFG/ESNFI/INGO/458,2047,1984,1497,1436,6964,990,1080,1313,1324,4707
23,Afghanistan,1,2015,AFG-15/3481/AFG/ESNFI/INGO/459,3191,3483,4034,4267,14975,3191,3483,4034,4267,14975
23,Afghanistan,1,2015,AFG-15/3481/AFG/ESNFI/INGO/461,1633,1746,2653,2858,8890,1406,1495,3606,3371,9878
23,Afghanistan,1,2015,AFG-15/3481/AFG/ESNFI/INGO/464,4417,3914,1004,703,10038,1402,1600,2009,1653,6664
23,Afghanistan,1,2015,AFG-15/3481/AFG/ESNFI/INGO/465,1231,1231,1846,1846,6154,1123,1983,2011,1194,6311
23,Afghanistan,1,2015,AFG-15/3481/AFG/ESNFI/INGO/469,494,495,604,605,2198,387,404,474,492,1757
23,Afghanistan,1,2015,AFG-15/3481/AFG/ESNFI/INGO/471,1641,1641,2461,2461,8204,1995,2137,4630,3830,12592
23,Afghanistan,1,2015,AFG-15/3481/AFG-15/3481/RA3//ESNFI/INGO/477,2520,2520,643,617,6300,1170,1182,2856,2307,7515
23,Afghanistan,2,2016,AFG-16/3481/SA1/H/INGO/481,6743,2816,2605,1921,14085,8762,3757,1656,1173,15348
23,Afghanistan,2,2016,AFG-16/3481/SA1/H/UN/482,169208,162439,175975,169208,676830,164492,157912,171070,164492,657966
23,Afghanistan,2,2016,AFG-16/3481/SA1/H/INGO/485,15892,3469,13880,3725,36966,18008,2935,13030,4208,38181
23,Afghanistan,2,2016,AFG-16/3481/SA1/N/INGO/486,260,110,0,0,370,184,83,0,0,267
23,Afghanistan,2,2016,AFG-16/3481/SA1/H/NGO/488,70628,73232,22744,23396,190000,14926,7004,4100,3478,29508
23,Afghanistan,2,2016,AFG-16/3481/SA1/ESNFI-FSAC-N-APC-WASH/INGO/491,23,23,23,23,92,23,23,23,23,92
23,Afghanistan,2,2016,AFG-16/3481/SA1/ESNFI/INGO/492,1120,1120,1680,1680,5600,821,943,1553,1473,4790
23,Afghanistan,2,2016,AFG-16/3481/SA1/ESNFI-FSAC/INGO/493,4000,4000,10000,10000,28000,4840,5504,7841,7314,25499
23,Afghanistan,2,2016,AFG-16/3481/SA1/H/NGO/502,7232,3276,2808,2340,15656,8316,1810,1388,1030,12544
23,Afghanistan,2,2016,AFG-16/3481/SA1/H/INGO/505,33101,7247,4498,3474,48320,41835,10479,8726,5449,66489
23,Afghanistan,2,2016,AFG-16/3481/SA1/H/NGO/506,11703,6120,7998,790,26611,16423,4480,5309,3151,29363
23,Afghanistan,2,2016,AFG-16/3481/SA1/APC/INGO/507,1000,7000,600,3000,11600,2366,14107,884,7042,24399
23,Afghanistan,2,2016,AFG-16/3481/SA1/H/NGO/509,52747,50678,64468,61941,229834,41051,71068,35631,34419,182169
23,Afghanistan,2,2016,AFG-16/3481/SA1/ESNFI-FSAC-N-APC-WASH/INGO/511,1,1,1,1,4,1,1,1,1,4
23,Afghanistan,2,2016,AFG-16/3481/SA1/ESNFI-FSAC-N-APC-WASH/INGO/514,1,1,1,1,4,1,1,1,1,4
23,Afghanistan,2,2016,AFG-16/3481/SA1/H/INGO/515,20577,20454,4950,5076,51057,23529,47871,15030,15192,101622
23,Afghanistan,2,2016,AFG-16/3481/SA1/FSAC-ESNFI/NGO/517,3505,3502,3499,3494,14000,3259,3359,5032,4856,16506
23,Afghanistan,2,2016,AFG-16/3481/SA1/H/NGO/518,3483,1160,826,274,5743,1422,1405,1504,1111,5442
23,Afghanistan,2,2016,AFG-16/3481/SA1/FSAC-WASH/INGO/531,3612,3612,4788,4788,16800,3612,3612,4788,4788,16800
23,Afghanistan,2,2016,AFG-16/3481/SA2/ESNFI/INGO/3259,326,308,385,379,1398,326,308,385,379,1398
23,Afghanistan,2,2016,AFG-16/3481/SA2/N/UN/3264,74,74,6971,6698,13817,82,6527,3264,3042,12915
23,Afghanistan,2,2016,AFG-16/3481/SA2/ESNFI/INGO/3266,519,519,608,608,2254,568,622,838,791,2819
23,Afghanistan,2,2016,AFG-16/3481/SA2/FSAC/INGO/3267,2121,1838,1626,1485,7070,2075,2171,3526,2935,10707
23,Afghanistan,2,2016,AFG-16/3481/SA2/APC/NGO/3272,2755,4932,693,776,9156,3557,7639,628,1077,12901
23,Afghanistan,2,2016,AFG-16/3481/SA2/H/NGO/3285,20210,19545,3904,3754,47413,13998,12168,6021,5800,37987
23,Afghanistan,2,2016,AFG-16/3481/SA2/APC/INGO/3294,1,1,1,1,4,469,157,0,0,626
23,Afghanistan,2,2016,AFG-16/3481/SA2/APC/INGO/3301,27384,27385,34855,34855,124479,33943,32277,68083,59511,193814
23,Afghanistan,2,2016,AFG-16/3481/SA2/H/INGO/3327,24281,16173,6063,4042,50559,4998,1456,756,534,7744
23,Afghanistan,2,2016,AFG-16/3481/SA2/APC/NGO/3328,23942,26866,35884,35885,122577,34817,32953,37763,35948,141481
23,Afghanistan,2,2016,AFG-16/3481/SA2/APC/INGO/3334,18218,6074,16035,8258,48585,9271,3741,62156,24773,99941
23,Afghanistan,2,2016,AFG-16/3481/SA2/WASH-H/INGO/3342,12051,12499,3004,3125,30679,10927,14468,8770,7696,41861
23,Afghanistan,2,2016,AFG-16/3481/SA2/FSAC/INGO/3347,2797,2320,3332,3451,11900,2737,2933,3964,3978,13612
23,Afghanistan,2,2016,AFG-16/3481/SA2/FSAC/INGO/3357,908,990,1919,1784,5601,908,990,1919,1784,5601
23,Afghanistan,2,2016,AFG-16/3481/SA2/WASH/INGO/3397,14141,12613,25226,24460,76440,3449,3813,8421,8010,23693
23,Afghanistan,2,2016,AFG-16/3481/SA2/H/UN/3412,76416,73764,75814,71995,297989,75237,72626,74645,70885,293393
23,Afghanistan,2,2016,AFG-16/3481/SA2/ESNFI/INGO/3420,241,263,305,321,1130,550,602,752,785,2689
23,Afghanistan,2,2016,AFG-16/3481/SA2/FSAC/INGO/3421,3363,3471,6573,6613,20020,4863,4890,6716,6646,23115
23,Afghanistan,2,2016,AFG-16/3481/SA2/H/NGO/3423,4385,1253,696,626,6960,2591,1325,1656,1049,6621
23,Afghanistan,2,2016,AFG-16/3481/SA2/FSAC/UN/3425,5730,5730,14350,14300,40110,5730,5730,14350,14300,40110
23,Afghanistan,2,2016,AFG-16/3481/SA2/H/INGO/3448,3140,1954,925,840,6859,5076,1448,1238,623,8385
23,Afghanistan,2,2016,AFG-16/3481/SA2/APC-H/INGO/3487,18264,18992,13199,13737,64192,20932,34007,15263,27609,97811
23,Afghanistan,2,2016,AFG-16/3481/SA2/N/UN/3488,0,30100,21616,21084,72800,0,70131,22364,26053,118548
23,Afghanistan,2,2016,AFG-16/3481/SA2/ESNFI/INGO/3504,7,7,7,7,28,8,9,9,9,35
23,Afghanistan,2,2016,AFG-16/3481/SA2/WASH/NGO/3534,689,886,3937,4330,9842,1404,1413,4318,3267,10402
23,Afghanistan,2,2016,AFG-16/3481/SA2/ESNFI/INGO/3535,232,230,429,322,1213,230,231,431,324,1216
23,Afghanistan,2,2016,AFG-16/3481/SA2/H-APC/INGO/3571,27069,26262,6598,8348,68277,20866,29006,12367,12519,74758
23,Afghanistan,2,2016,AFG-16/3481/SA2/APC/NGO/3598,29379,29381,35912,35911,130583,24590,20100,45437,47996,138123
23,Afghanistan,2,2016,AFG-16/3481/SA2/N/INGO/3605,2375,2942,2740,2700,10757,2854,4315,5082,4922,17173
23,Afghanistan,2,2016,AFG-16/3481/SA2/N/INGO/3606,127,49,0,0,176,202,78,0,0,280
23,Afghanistan,2,2016,AFG-16/3481/SA2/N/INGO/3607,2494,2446,4297,4403,13640,2260,4199,4074,3872,14405
23,Afghanistan,2,2016,AFG-16/3481/SA2/WASH/INGO/3613,3959,5278,1847,2111,13195,2240,2288,4828,3834,13190
23,Afghanistan,2,2016,AFG-16/3481/SA2/H/INGO/3658,380,420,992,1008,2800,703,714,907,944,3268
23,Afghanistan,2,2016,AFG-16/3481/SA2/FSAC/INGO/3662,2835,3045,2100,2520,10500,3385,3151,2801,2334,11671
23,Afghanistan,2,2016,AFG-16/3481/SA2/N/INGO/3666,184,1526,1430,1488,4628,204,5740,3826,4351,14121
23,Afghanistan,2,2016,AFG-16/3481/SA2/APC/NGO/3667,2027,1988,727,658,5400,2027,1988,727,658,5400
23,Afghanistan,1,2016,AFG-16/3481/AFG/APC/INGO/3784,1000,1250,1875,1875,6000,246,191,355,239,1031
23,Afghanistan,1,2016,AFG-16/3481/AFG/H-WASH-ESNFI/INGO/3811,17282,17922,14082,14720,64006,20441,31570,18014,18055,88080
23,Afghanistan,1,2016,AFG-16/3481/AFG/FSAC/INGO/3812,1826,1826,2738,2738,9128,1299,1299,1950,1950,6498
23,Afghanistan,1,2016,AFG-16/3481/AFG/N/NGO/3816,421,52928,43092,41402,137843,904,63179,35030,36972,136085
23,Afghanistan,1,2016,AFG-16/3481/AFG/H-APC/INGO/3829,28301,28286,18841,18841,94269,29580,26520,21536,17455,95091
23,Afghanistan,1,2016,AFG-16/3481/AFG/ESNFI/NGO/3833,2781,2795,3899,3965,13440,2781,2795,3899,3965,13440
23,Afghanistan,1,2016,AFG-16/3481/AFG/FSAC/NGO/3839,2230,2242,3124,3177,10773,2230,2242,3124,3177,10773
23,Afghanistan,1,2016,AFG-16/3481/AFG/ESNFI/INGO/3856,1138,1200,2454,2290,7082,1229,1252,2421,2383,7285
23,Afghanistan,1,2016,AFG-16/3481/AFG/APC/INGO/3865,2534,2656,3801,3938,12929,2482,2602,3749,3886,12719
23,Afghanistan,1,2016,AFG-16/3481/RA2/CCS/UN/4432,360,0,0,0,360,74,0,0,0,74
23,Afghanistan,1,2016,AFG-16/3481/RA3/MS/INGO/4491,2,2,2,2,8,2,2,2,2,8
23,Afghanistan,2,2017,AFG-17/3481/1SA/ESNFI-APC/INGO/4961,1540,1681,8928,8840,20989,3910,3577,19237,13765,40489
23,Afghanistan,2,2017,AFG-17/3481/1SA/H/NGO/4966,9650,5044,3619,3619,21932,13469,10916,10117,8328,42830
23,Afghanistan,2,2017,AFG-17/3481/1SA/APC/INGO/4980,150,150,2430,2070,4800,104,46,2197,2086,4433
23,Afghanistan,2,2017,AFG-17/3481/1SA/APC-H/INGO/4985,1309,5863,2500,2500,12172,25016,21264,2574,2566,51420
23,Afghanistan,2,2017,AFG-17/3481/1SA/H/UN/4987,30000,180000,15000,75000,300000,9507,147760,4834,49345,211446
23,Afghanistan,2,2017,AFG-17/3481/1SA/H/INGO/5000,13899,13443,3399,3194,33935,7055,14642,3843,4244,29784
23,Afghanistan,2,2017,AFG-17/3481/1SA/H/INGO/5005,11112,1928,8495,2475,24010,12299,2453,11248,3511,29511
23,Afghanistan,2,2017,AFG-17/3481/1SA/APC/INGO/5006,42,43,2650,2650,5385,42,43,2220,2280,4585
23,Afghanistan,2,2017,AFG-17/3481/1SA/WASH-ESNFI-APC/INGO/5014,1492,3088,4274,6400,15254,2624,3331,4487,7074,17516
23,Afghanistan,2,2017,AFG-17/3481/1SA/APC-ESNFI/INGO/5015,1792,1904,3774,3730,11200,2128,2261,4480,4431,13300
23,Afghanistan,2,2017,AFG-17/3481/1SA/APC/NGO/5020,53077,55604,70769,73296,252746,63573,61821,74769,71581,271744
23,Afghanistan,2,2017,AFG-17/3481/1SA/H/INGO/5022,18159,41362,14784,15456,89761,16862,33527,10046,9631,70066
23,Afghanistan,2,2017,AFG-17/3481/1SA/WASH/INGO/5023,12950,11550,23100,22400,70000,8296,8584,12665,13097,42642
23,Afghanistan,2,2017,AFG-17/3481/1SA/ESNFI/INGO/5024,2182,2129,3246,3087,10644,2349,2292,3495,3324,11460
23,Afghanistan,2,2017,AFG-17/3481/1SA/FSAC/INGO/5031,1827,1938,3671,3079,10515,2107,2295,4045,4136,12583
23,Afghanistan,2,2017,AFG-17/3481/1SA/FSAC-ESNFI-WASH-APC-N/INGO/5032,43,44,44,44,175,43,44,44,44,175
23,Afghanistan,2,2017,AFG-17/3481/1SA/N/INGO/5040,5067,31013,9112,10696,55888,6088,50111,8329,10471,74999
23,Afghanistan,2,2017,AFG-17/3481/1SA/WASH/NGO/5042,4061,4889,8631,10384,27965,4042,4901,8644,10378,27965
23,Afghanistan,2,2017,AFG-17/3481/1SA/ESNFI/INGO/5075,3675,3675,0,0,7350,0,0,0,0,0
23,Afghanistan,2,2017,AFG-17/3481/1SA/APC/NGO/5131,46845,46845,57255,57255,208200,38085,26032,98683,78492,241292
23,Afghanistan,2,2017,AFG-17/3481/1SA/N/INGO/5146,70,12054,6941,7827,26892,95,10270,5349,7398,23112
23,Afghanistan,2,2017,AFG-17/3481/1SA/FSAC/INGO/5172,3147,3123,3483,2157,11910,1575,1901,4217,4243,11936
23,Afghanistan,2,2017,AFG-17/3481/1SA/H/UN/5183,121402,126355,148379,154435,550571,65170,67830,79652,82932,295584
23,Afghanistan,2,2017,AFG-17/3481/1SA/N/UN/5194,0,0,15180,17820,33000,0,0,15271,17926,33197
23,Afghanistan,2,2017,AFG-17/3481/1SA/N/UN/5212,0,21069,14625,14065,49759,0,21297,9378,12529,43204
23,Afghanistan,1,2017,AFG-17/3481/RA1/APC/INGO/6304,28000,28000,42000,42000,140000,9177,7710,15904,12786,45577
23,Afghanistan,2,2017,AFG-17/3481/SA2/APC-FSAC-WASH/INGO/6739,87474,92339,160348,145799,485960,134923,134352,144844,143893,558012
23,Afghanistan,2,2017,AFG-17/3481/SA2/N-APC-FSAC-WASH-CCS/INGO/6749,5474,5017,17030,20360,47881,12886,13579,10451,8309,45225
23,Afghanistan,2,2017,AFG-17/3481/SA2/H-N-APC/NGO/6764,3085,3347,7766,7566,21764,3258,4384,3913,3696,15251
23,Afghanistan,2,2017,AFG-17/3481/SA2/H-APC-WASH/INGO/6777,13464,24606,4178,4178,46426,3274,6290,1830,1688,13082
23,Afghanistan,2,2017,AFG-17/3481/SA2/FSAC-WASH-APC/NGO/6784,3941,4271,9154,8451,25817,3754,4068,8719,8050,24591
23,Afghanistan,2,2017,AFG-17/3481/SA2/H-WASH-APC/INGO/6787,25270,27755,17637,18469,89131,10308,17622,10664,9408,48002
23,Afghanistan,2,2017,AFG-17/3481/SA2/FSAC-CCS-APC/NGO/6788,12570,14566,18464,20592,66192,13543,15573,19604,21360,70080
23,Afghanistan,2,2017,AFG-17/3481/SA2/H-APC-N/NGO/6792,7346,11597,4598,8228,31769,8220,14529,6766,7722,37237
23,Afghanistan,2,2017,AFG-17/3481/SA2/FSAC-WASH-APC/INGO/6794,1230,1230,1395,1395,5250,2462,2518,3100,3711,11791
23,Afghanistan,2,2017,AFG-17/3481/SA2/APC-H-N/INGO/6797,48910,50866,36831,38335,174942,38544,69242,42595,45096,195477
23,Afghanistan,2,2017,AFG-17/3481/SA2/H-N-APC/NGO/6817,8004,8356,10999,10619,37978,22414,23229,5706,5832,57181
23,Afghanistan,2,2017,AFG-17/3481/SA2/APC/NGO/6821,77148,57861,154296,96435,385740,84884,62018,162220,98956,408078
23,Afghanistan,2,2017,AFG-17/3481/SA2/WASH-FSAC-APC/NGO/6825,9058,9102,12688,12908,43756,9771,9818,13688,13924,47201
23,Afghanistan,2,2017,AFG-17/3481/SA2/APC/NGO/6828,63333,66499,91832,94999,316663,81538,79117,87569,83133,331357
23,Afghanistan,2,2017,AFG-17/3481/SA2/H-N-WASH-APC-CCS/UN/6829,231234,424530,324350,133430,1113544,206504,379128,289662,119161,994455
23,Afghanistan,2,2017,AFG-17/3481/SA2/WASH-N-APC/INGO/6849,19344,18579,9960,10032,57915,13587,14020,9527,9637,46771
23,Afghanistan,2,2017,AFG-17/3481/SA2/CCS/INGO/6852,12,12,12,12,48,12,12,12,12,48
23,Afghanistan,2,2017,AFG-17/3481/SA2/H-N-APC/INGO/6860,8034,7546,2238,2082,19900,6906,7745,3725,2959,21335
23,Afghanistan,2,2017,AFG-17/3481/SA2/H-FSAC-APC-ESNFI-WASH-CCS/INGO/6861,10335,10829,13781,14273,49218,6421,12155,7090,7690,33356
23,Afghanistan,2,2017,AFG-17/3481/SA2/APC-WASH-ESNFI/NGO/6863,4700,7300,5200,5450,22650,4110,4654,4045,4181,16990
23,Afghanistan,1,2017,AFG-17/3481/RA2/H/UN/6886,24347,22001,16860,15750,78958,4000,3700,2800,2500,13000
23,Afghanistan,1,2017,AFG-17/3481/RA3/N/UN/7319,0,0,20738,24344,45082,0,0,13542,15898,29440
23,Afghanistan,1,2017,AFG-17/3481/RA4/H/INGO/7609,6221,581,2183,751,9736,6979,649,2978,895,11501
23,Afghanistan,1,2017,AFG-17/3481/RA4/FSAC/INGO/7611,2250,2250,3000,3000,10500,2584,2600,3990,4000,13174
23,Afghanistan,1,2017,AFG-17/3481/RA4/APC/UN/7613,2020,1940,2570,2470,9000,1819,2190,3598,3264,10871
23,Afghanistan,2,2018,AFG-18/3481/SA1/N/UN/7665,0,0,18751,22918,41669,0,0,16389,19240,35629
23,Afghanistan,2,2018,AFG-18/3481/SA1/N/UN/7668,0,10215,30474,28284,68973,0,5859,2711,3111,11681
23,Afghanistan,2,2018,AFG-18/3481/SA1/ESNFI/NGO/7669,3780,5040,1260,2520,12600,3780,5040,1260,2520,12600
23,Afghanistan,2,2018,AFG-18/3481/SA1/EIE-CPiE/INGO/7670,575,598,4328,4505,10006,245,190,1246,1588,3269
23,Afghanistan,2,2018,AFG-18/3481/SA1/H-WASH/INGO/7671,4815,4669,3175,3115,15774,3791,2468,5691,4536,16486
23,Afghanistan,2,2018,AFG-18/3481/SA1/WASH-ESNFI/INGO/7682,3989,4118,2582,2432,13121,2379,1276,1490,603,5748
23,Afghanistan,2,2018,AFG-18/3481/SA1/H/INGO/7685,6429,637,2085,526,9677,5016,536,1625,370,7547
23,Afghanistan,2,2018,AFG-18/3481/SA1/N-WASH-GBV/INGO/7687,7043,18916,7817,8271,42047,581,4343,1510,1818,8252
23,Afghanistan,2,2018,AFG-18/3481/SA1/ESNFI-WASH/NGO/7688,5027,5052,7046,7165,24290,4952,4977,6939,7058,23926
23,Afghanistan,2,2018,AFG-18/3481/SA1/ESNFI/INGO/7690,1456,1329,1899,1646,6330,1575,1437,2053,1779,6844
23,Afghanistan,2,2018,AFG-18/3481/SA1/H-N-GBV-CPiE/INGO/7691,9728,7806,10823,10839,39196,3871,14390,14429,13393,46083
23,Afghanistan,2,2018,AFG-18/3481/SA1/ESNFI/INGO/7693,1058,1127,1946,1784,5915,926,1123,1973,2095,6117
23,Afghanistan,2,2018,AFG-18/3481/SA1/WASH-ESNFI-CPiE/INGO/7694,3054,2986,5734,5786,17560,2866,3170,4206,4256,14498
23,Afghanistan,2,2018,AFG-18/3481/SA1/WASH-GBV-CPiE/NGO/7700,5705,4336,6618,6161,22820,2644,2178,2813,2455,10090
23,Afghanistan,2,2018,AFG-18/3481/SA1/WASH/INGO/7701,8024,9819,18618,15937,52398,2787,2968,6400,5600,17755
23,Afghanistan,2,2018,AFG-18/3481/SA1/H-N/NGO/7702,3047,20351,30257,33752,87407,1666,6852,15275,14291,38084
23,Afghanistan,2,2018,AFG-18/3481/SA1/ESNFI/INGO/7703,1044,1093,1392,1441,4970,0,0,0,0,0
23,Afghanistan,2,2018,AFG-18/3481/SA1/H-APC/INGO/7705,3235,3505,2105,1740,10585,1171,1163,700,475,3509
23,Afghanistan,2,2018,AFG-18/3481/SA1/EIE/INGO/7706,704,708,11139,11594,24145,845,526,3201,3285,7857
23,Afghanistan,2,2018,AFG-18/3481/SA1/WASH/INGO/7711,22680,22680,34020,34020,113400,10844,11480,15094,16225,53643
23,Afghanistan,2,2018,AFG-18/3481/SA1/WASH-ESNFI/INGO/7713,2289,2300,3207,3264,11060,2268,2579,4166,4292,13305
23,Afghanistan,2,2018,AFG-18/3481/SA1/GBV-CPiE-ESNFI/NGO/7714,5145,7560,6823,6622,26150,1768,1844,2365,2180,8157
23,Afghanistan,1,2018,AFG-18/3481/RA1/WASH/INGO/8807,18778,19939,15363,16314,70394,5504,6650,9621,10587,32362
23,Afghanistan,1,2018,AFG-18/3481/RA2/CCS/UN/9472,12640,3200,80,80,16000,4490,1476,659,247,6872
17,CAR,2,2014,CAR-14/SPA3/HLT/INGO/1048,26,4700,6732,7293,18751,3983,13275,12819,12295,42372
17,CAR,2,2014,CAR-14/SPA3/HLT/NGO/1050,47452,55096,34133,35526,172207,23083,29497,16987,17056,86623
17,CAR,2,2014,CAR-14/SPA3/NUT/INGO/1051,310,316,6895,7064,14585,16,1085,5607,5992,12700
17,CAR,2,2014,CAR-14/SPA3/NUT/UN/1052,0,0,2080,1920,4000,0,0,2248,2076,4324
17,CAR,2,2014,CAR-14/SPA3/PROT/NGO/1053,6160,5491,6014,7030,24695,16085,24128,8535,12803,61551
17,CAR,2,2014,CAR-14/SPA3/PROT/NGO/1054,800,860,1180,1800,4640,1102,1627,2301,2248,7278
17,CAR,2,2014,CAR-14/SPA3/PROT/NGO/1055,14000,22700,41650,43350,121700,62083,66299,43506,53174,225062
17,CAR,2,2014,CAR-14/SPA3/EDU/NGO/1056,1113,1449,2051,1712,6325,1113,1449,2051,1712,6325
17,CAR,2,2014,CAR-14/SPA3/HLT/NGO/1057,30350,45524,37937,37937,151748,30350,45524,37937,37937,151748
17,CAR,1,2014,CAR-14/R/EDU/INGO/1058,32,11,4687,5608,10338,0,0,0,0,0
17,CAR,2,2014,CAR-14/SPA3/WaSH/INGO/1059,15312,45932,14122,14698,90064,22948,23885,21183,22048,90064
17,CAR,2,2014,CAR-14/SPA3/EDU/UN/1060,322,153,15000,15000,30475,263,106,15924,15547,31840
17,CAR,2,2014,CAR-14/SPA3/WaSH/INGO/1061,10247,10730,10308,10665,41950,11593,11840,11008,11060,45501
17,CAR,2,2014,CAR-14/SPA3/COORD/UN/1067,60,0,0,0,60,60,0,0,0,60
17,CAR,2,2014,CAR-14/SPA3/FSEC/INGO/1068,3801,3893,2523,2853,13070,21936,12264,0,0,34200
17,CAR,1,2014,CAR-14/R/NFI/INGO/1070,418,438,134,146,1136,418,438,134,146,1136
17,CAR,1,2014,CAR-14/R/NFI/INGO/1074,4415,4595,0,0,9010,5898,7876,3795,2877,20446
17,CAR,2,2014,CAR-14/SPA3/EDU/NGO/1076,200,120,40,40,400,107,285,30,35,457
17,CAR,2,2014,CAR-14/SPA2/NUT/INGO/1080,47927,70910,9888,9628,138353,50935,53015,10805,11245,126000
17,CAR,2,2014,CAR-14/SPA3/HLT-PROT/NGO/1081,837,7144,6388,8000,22369,2438,9199,11150,10446,33233
17,CAR,2,2014,CAR-14/SPA2/PROT-NFI-FSEC-WaSH/INGO/1082,11729,11700,13469,13469,50367,8508,8775,11375,11305,39963
17,CAR,2,2014,CAR-14/SPA2/FSEC-HLT/NGO/1083,7000,8600,7000,5200,27800,6349,11125,10300,7448,35222
17,CAR,1,2014,CAR-14/R/WaSH/INGO/1085,5072,6723,1242,1580,14617,0,0,0,0,0
17,CAR,2,2014,CAR-14/HCF10/SPA3/FSEC/INGO/1086,2912,3320,998,1090,8320,2912,3320,998,1090,8320
17,CAR,2,2014,CAR-14/HCF10/SPA3/NUT/INGO/1088,25503,30098,20345,21175,97121,11772,9147,3848,3640,28407
17,CAR,2,2014,CAR-14/HCF10/SPA3/CCCM/INGO/1090,28238,29376,0,0,57614,0,0,0,0,0
17,CAR,2,2014,CAR-14/HCF10/SPA3/WaSH-PROT/INGO/1092,2833,5328,1137,1202,10500,2833,5328,1137,1202,10500
17,CAR,2,2014,CAR-14/HCF10/SPA3/PROT-EDU/INGO/1093,1546,1674,3302,3438,9960,3826,2728,17467,12716,36737
17,CAR,2,2014,CAR-14/HCF10/SPA2/PROT/INGO/1096,4000,5000,2880,3120,15000,0,0,0,0,0
17,CAR,2,2014,CAR-14/HCF10/SPA2/PROT/INGO/1098,7810,10750,1050,1450,21060,7966,11489,2852,3343,25650
17,CAR,2,2014,CAR-14/HCF10/SPA2/HLT/UN/1100,65921,68612,46534,48433,229500,40072,43412,29210,28642,141336
17,CAR,2,2014,CAR-14/HCF10/SPA2/NFI-WaSH/INGO/1101,5057,7693,6125,6125,25000,4276,5665,5302,5333,20576
17,CAR,1,2014,CAR-14/HCF10/R/EDU/NGO/1103,453,87,18000,10000,28540,453,87,18000,10277,28817
17,CAR,1,2014,CAR-14/HCF10/R/EDU/INGO/1104,7750,7000,4570,3950,23270,12990,8216,6997,4625,32828
17,CAR,2,2014,CAR-14/HCF10/SPA2/NUT-PROT/INGO/1105,6154,24280,7200,10800,48434,6154,24280,7200,10800,48434
17,CAR,2,2015,CAR-15/HCF10/SA1/FSEC/NGO/1112,2325,2400,125,150,5000,2445,2280,130,145,5000
17,CAR,2,2015,CAR-15/HCF10/SA1/PROT/INGO/1120,347,4164,347,2082,6940,101,1921,6,165,2193
17,CAR,1,2015,CAR-15/HCF10/R/CCCM/INGO/1125,9671,9282,403,807,20163,4747,4747,5802,5802,21098
17,CAR,2,2015,CAR-15/HCF10/SA1/FSEC/INGO/1126,7641,13584,3113,3962,28300,14110,14190,0,0,28300
17,CAR,2,2015,CAR-15/HCF10/SA1/WaSH/INGO/1128,11000,11000,16500,16500,55000,16313,16313,24470,24470,81566
17,CAR,2,2015,CAR-15/HCF10/SA1/PROT-ER/INGO/1129,150,200,400,500,1250,148,250,1883,2122,4403
17,CAR,2,2015,CAR-15/HCF10/SA1/HLT-PROT/INGO/1131,7785,15565,10895,10895,45140,13625,20494,22625,19403,76147
17,CAR,2,2015,CAR-15/HCF10/SA1/EDU/INGO/1132,49,16,3824,2326,6215,54,6,4003,2450,6513
17,CAR,2,2015,CAR-15/HCF10/SA1/NUT/INGO/1141,0,2720,4940,7410,15070,0,1469,2118,3807,7394
17,CAR,2,2015,CAR-15/HCF10/SA1/FSEC-ER/NGO/1143,7975,7975,9225,9425,34600,8300,8500,9480,9725,36005
17,CAR,2,2015,CAR-15/HCF10/SA1/HLT/INGO/1150,95,50,23600,18600,42345,163,210,29683,12721,42777
17,CAR,2,2015,CAR-15/HCF10/SA1/EDU/INGO/1152,72,34,2093,2437,4636,130,78,2584,2216,5008
17,CAR,2,2015,CAR-15/HCF10/SA1/PROT/INGO/1161,4495,4495,2765,2775,14530,4567,4519,3326,3187,15599
17,CAR,2,2015,CAR-15/HCF10/SA1/HLT-NUT-PROT/INGO/1163,5689,5921,0,0,11610,3575,4645,0,0,8220
17,CAR,2,2015,CAR-15/HCF10/SA1/ER/INGO/1166,4400,5000,3500,4000,16900,2200,2500,1750,2000,8450
17,CAR,2,2015,CAR-15/HCF10/SA1/NFI/INGO/1173,4125,4125,4125,4125,16500,1303,1729,2735,2849,8616
17,CAR,2,2015,CAR-15/HCF10/SA1/ER/INGO/1176,30,90,0,0,120,84,78,0,0,162
17,CAR,2,2015,CAR-15/HCF10/SA1/ER/INGO/1177,48,47,30,20,145,84,45,30,20,179
17,CAR,2,2015,CAR-15/HCF10/SA1/PROT-HLT/NGO/1188,1750,7250,1870,2130,13000,1850,6990,1520,2540,12900
17,CAR,2,2015,CAR-15/HCF10/SA1/HLT/INGO/1189,10945,11392,8257,8594,39188,1031,1409,3879,3460,9779
17,CAR,2,2015,CAR-15/HCF10/SA1/WaSH/NGO/1192,3994,5681,3525,4250,17450,3790,5600,3425,4050,16865
17,CAR,2,2015,CAR-15/HCF10/SA1/PROT/UN/1201,80,70,6500,6500,13150,99,29,6124,4818,11070
17,CAR,1,2015,CAR-15/HCF10/R/NUT-HLT/INGO/1208,0,767,611,662,2040,0,137,934,1012,2083
17,CAR,1,2015,CAR-15/HCF10/R/CCCM/UN/1210,4036,4201,5121,5005,18363,4036,4201,5121,5005,18363
17,CAR,1,2015,CAR-15/HCF10/R/CCCM/NGO/1211,2006,4011,1003,3008,10028,2485,4969,1243,3726,12423
17,CAR,1,2015,CAR-15/HCF10/R/CCCM/NGO/1212,2684,5374,1343,4031,13432,1565,1612,2752,2397,8326
17,CAR,1,2015,CAR-15/HCF10/R/NFI/UN/1215,28738,29912,27611,28739,115000,20913,21750,20076,20913,83652
17,CAR,1,2015,CAR-15/HCF10/R/FSEC/UN/1220,3240,2160,1800,1800,9000,5400,3600,3000,3000,15000
17,CAR,2,2015,CAR-15/HCF10/9/NUT/UN/1238,0,0,3867,4189,8056,0,0,3630,3933,7563
17,CAR,2,2015,CAR-15/HCF10/9/HLT/INGO/1243,8000,15363,9290,11052,43705,8711,13352,9394,10131,41588
17,CAR,2,2015,CAR-15/HCF10/9/NUT/INGO/1246,0,1670,400,316,2386,24,1670,3357,3471,8522
17,CAR,2,2015,CAR-15/HCF10/9/EDU/NGO/1252,244,46,6715,3397,10402,244,46,7250,4698,12238
17,CAR,2,2015,CAR-15/HCF10/9/PROT/NGO/1254,438,1813,468,533,3252,450,1903,424,475,3252
17,CAR,2,2015,CAR-15/HCF10/9/ER/NGO/1258,3746,4054,3777,4083,15660,3746,4054,3777,4083,15660
17,CAR,2,2015,CAR-15/HCF10/9/HLT-PROT/INGO/1260,11939,13463,3116,3514,32032,4616,11648,13533,13576,43373
17,CAR,2,2015,CAR-15/HCF10/9/NUT/INGO/1261,303,8527,1235,1313,11378,0,0,1695,1824,3519
17,CAR,2,2015,CAR-15/HCF10/9/HLT/INGO/1266,4905,6914,5163,5927,22909,5820,7015,5598,8313,26746
17,CAR,2,2015,CAR-15/HCF10/9/WaSH/INGO/1267,186,103,125,109,523,0,0,0,0,0
17,CAR,2,2015,CAR-15/HCF10/9/NFI/NGO/1274,225,125,300,300,950,225,125,300,300,950
17,CAR,2,2015,CAR-15/HCF10/9/NUT/INGO/1276,0,148,1546,1659,3353,0,17,1274,1659,2950
17,CAR,2,2015,CAR-15/HCF10/9/LOG/INGO/1277,17850,17150,0,0,35000,24480,23520,0,0,48000
17,CAR,2,2015,CAR-15/HCF10/9/PROT/INGO/1280,4425,4600,4650,4950,18625,1280,1119,753,715,3867
17,CAR,2,2015,CAR-15/HCF10/9/NUT/INGO/1281,0,6069,6272,6272,18613,0,6069,6272,6272,18613
17,CAR,2,2015,CAR-15/HCF10/9/FSEC/INGO/1287,1530,2425,480,1045,5480,1479,2325,423,1057,5284
17,CAR,2,2015,CAR-15/HCF10/9/NUT/INGO/1288,340,515,7923,7922,16700,323,816,11268,11701,24108
17,CAR,2,2015,CAR-15/HCF10/9/ER/INGO/1291,3704,3856,0,0,7560,3704,3856,0,0,7560
17,CAR,2,2015,CAR-15/HCF10/9/FSEC/INGO/1293,2189,2181,3086,2544,10000,7574,5682,5,0,13261
17,CAR,2,2015,CAR-15/HCF10/9/EDU/UN/1301,87,57,4450,5550,10144,132,117,6547,5917,12713
17,CAR,2,2015,CAR-15/HCF10/9/WaSH/INGO/1303,7890,8000,8229,8113,32232,9991,10129,10419,10272,40811
17,CAR,2,2015,CAR-15/HCF10/9/FSEC/INGO/1304,250,1150,1250,1550,4200,300,366,1165,2568,4399
17,CAR,2,2015,CAR-15/HCF10/9/WaSH/INGO/1316,15395,14791,0,0,30186,8167,8398,8618,8848,34031
17,CAR,2,2015,CAR-15/HCF10/9/ER/INGO/1320,690,1455,1280,1380,4805,4115,6172,0,0,10287
17,CAR,2,2015,CAR-15/HCF10/9/PROT/INGO/1321,1400,1460,1950,2050,6860,547,778,245,400,1970
17,CAR,2,2015,CAR-15/HCF10/9/WaSH/INGO/1322,1825,1825,1825,1825,7300,1722,1652,2315,2362,8051
17,CAR,2,2015,CAR-15/HCF10/9/WaSH/INGO/1330,11933,12420,12420,12927,49700,11045,11495,11495,11965,46000
17,CAR,2,2015,CAR-15/HCF10/9/NFI/INGO/1332,3860,5434,6930,6930,23154,1282,2568,10676,13608,28134
17,CAR,2,2015,CAR-15/HCF10/9/HLT/UN/1335,2465,3579,7431,8050,21525,1600,1100,4300,4000,11000
17,CAR,2,2015,CAR-15/HCF10/9/PROT/UN/1338,10,390,270,130,800,18,557,409,359,1343
17,CAR,2,2015,CAR-15/HCF10/9/ER/INGO/1339,12350,24942,14400,15117,66809,6000,12900,7000,7100,33000
17,CAR,2,2015,CAR-15/HCF10/9/EDU/INGO/1354,4503,4503,450,500,9956,3641,3298,1703,1415,10057
17,CAR,2,2015,CAR-15/HCF10/9/FSEC/INGO/1357,3529,3674,3674,3823,14700,5465,5246,5682,5465,21858
17,CAR,2,2015,CAR-15/HCF10/9/NFI/INGO/1361,1000,1000,1500,1500,5000,1303,1642,1925,3392,8262
17,CAR,1,2015,CAR-15/HCF10/R/CCCM/INGO/1368,4500,4500,5500,5500,20000,6079,6849,7647,7487,28062
17,CAR,2,2016,CAR-16/HCF10/10/PROT/NGO/1374,4000,5200,5600,4400,19200,4137,6039,7308,5317,22801
17,CAR,2,2016,CAR-16/HCF10/10/WaSH/NGO/1384,3681,4276,1348,2289,11594,2145,3052,752,1452,7401
17,CAR,2,2016,CAR-16/HCF10/10/WaSH/UN/1387,5500,5600,2600,2800,16500,10425,10525,4825,5225,31000
17,CAR,2,2016,CAR-16/HCF10/10/EDU/NGO/1388,2849,3560,6465,7837,20711,2900,3500,5450,5970,17820
17,CAR,2,2016,CAR-16/HCF10/10/FSEC/NGO/1390,900,1100,1350,1650,5000,900,1100,1350,1650,5000
17,CAR,2,2016,CAR-16/HCF10/10/PROT/NGO/1391,3700,4100,4000,4100,15900,6000,7500,7000,5000,25500
17,CAR,2,2016,CAR-16/HCF10/10/NUT/INGO/1393,3500,11500,969,930,16899,3560,5810,243,290,9903
17,CAR,2,2016,CAR-16/HCF10/10/EDU/INGO/1395,320,113,6200,4125,10758,321,23,6214,4186,10744
17,CAR,2,2016,CAR-16/HCF10/10/HLT/INGO/1406,168,143,28410,18940,47661,257,204,25622,48805,74888
17,CAR,2,2016,CAR-16/HCF10/10/PROT/INGO/1410,30936,20624,38670,38670,128900,13066,13692,26252,23381,76391
17,CAR,2,2016,CAR-16/HCF10/10/PROT/INGO/1415,7826,8479,8152,8156,32613,7923,9850,7652,8565,33990
17,CAR,2,2016,CAR-16/HCF10/10/WaSH/INGO/1416,5056,5344,4512,5088,20000,2385,2482,3577,3728,12172
17,CAR,2,2016,CAR-16/HCF10/10/FSEC/NGO/1418,1138,1238,1188,1386,4950,1138,1238,1188,1386,4950
17,CAR,2,2016,CAR-16/HCF10/10/CCCM/INGO/1422,6079,6849,7647,7487,28062,0,0,0,0,0
17,CAR,2,2016,CAR-16/HCF10/10/HLT/INGO/1424,21903,23581,22426,22516,90426,21903,23581,22426,22516,90426
17,CAR,2,2016,CAR-16/HCF10/10/FSEC/INGO/1426,1677,1678,1698,1697,6750,1200,1563,1074,1400,5237
17,CAR,2,2016,CAR-16/HCF10/10/FSEC/UN/1431,1000,2100,0,0,3100,1335,1865,0,0,3200
17,CAR,2,2016,CAR-16/HCF10/10/HLT/INGO/1432,11049,11501,0,0,22550,4122,4998,0,0,9120
17,CAR,2,2016,CAR-16/HCF10/10/NFI/INGO/1437,2939,4327,5250,5250,17766,4781,4975,4840,5314,19910
17,CAR,2,2016,CAR-16/HCF10/10/FSEC/INGO/1443,1521,1855,817,994,5187,879,1073,473,575,3000
17,CAR,2,2016,CAR-16/HCF10/10/HLT/INGO/1446,83,5169,6214,6467,17933,78,685,2691,5241,8695
17,CAR,2,2016,CAR-16/HCF10/10/PROT/INGO/1451,377,377,5110,5790,11654,370,350,5000,5600,11320
17,CAR,2,2016,CAR-16/HCF10/10/EDU/NGO/1454,30,33,1248,1252,2563,30,33,1248,1252,2563
17,CAR,2,2016,CAR-16/HCF10/10/HLT-PROT/UN/1455,28514,21649,17231,16477,83871,22527,16886,16893,14964,71270
17,CAR,2,2016,CAR-16/HCF10/10/NFI/INGO/1469,0,0,0,25,25,0,0,0,25,25
17,CAR,2,2016,CAR-16/HCF10/10/WaSH/INGO/1474,2008,2046,1996,2079,8129,2405,3541,2668,4002,12616
17,CAR,2,2016,CAR-16/HCF10/10/NFI/INGO/1476,389,359,557,428,1733,487,402,329,346,1564
17,CAR,2,2016,CAR-16/HCF10/10/NFI/NGO/1481,4368,4396,5406,5517,19687,4546,4543,5754,5518,20361
17,CAR,2,2016,CAR-16/HCF10/10/WaSH/INGO/1482,0,40,0,0,40,0,0,0,0,0
17,CAR,2,2016,CAR-16/HCF10/10/WaSH-NUT-HLT/INGO/1483,2177,2737,2464,2622,10000,1934,2252,1743,1820,7749
17,CAR,2,2016,CAR-16/HCF10/10/NUT-HLT/INGO/1492,129,700,1452,1511,3792,100,27,403,379,909
17,CAR,2,2016,CAR-16/HCF10/10/WaSH/INGO/1494,3600,3750,3750,3900,15000,23719,24707,24707,25696,98829
17,CAR,2,2016,CAR-16/HCF10/10/HLT/NGO/1497,954,1215,659,772,3600,0,0,0,0,0
17,CAR,2,2016,CAR-16/HCF10/10/PROT/INGO/1501,120029,126029,174041,180043,600142,128360,134660,185856,192256,641132
17,CAR,1,2016,CAR-16/HCF10/R/WaSH/INGO/1504,5501,5726,5725,5959,22911,4257,4325,5598,5603,19783
17,CAR,1,2016,CAR-16/HCF10/R/LOG/INGO/1506,0,33,0,0,33,0,13,0,0,13
17,CAR,1,2016,CAR-16/HCF10/R/LOG/INGO/3172,16,0,0,0,16,14,0,0,0,14
17,CAR,1,2016,CAR-16/HCF10/R/WaSH/UN/3609,16500,17000,8000,8500,50000,45210,46580,21920,23290,137000
17,CAR,1,2016,CAR-16/HCF10/R/WaSH/INGO/3610,2448,2482,2553,2517,10000,2745,3195,2478,2582,11000
17,CAR,1,2016,CAR-16/HCF10/R/ER/INGO/3612,37306,43795,74614,87590,243305,0,0,0,0,0
17,CAR,1,2016,CAR-16/HCF10/R/WaSH/UN/3616,9576,9966,7834,8155,35531,11136,11548,9073,9486,41243
17,CAR,2,2016,CAR-16/HCF10/12/EDU/INGO/3908,62,4,1738,929,2733,50,2,1760,1152,2964
17,CAR,2,2016,CAR-16/HCF10/12/PROT/NGO/3910,5300,7900,5096,7100,25396,5700,14800,5200,4300,30000
17,CAR,2,2016,CAR-16/HCF10/12/HLT/INGO/3918,7273,10940,4058,5389,27660,6666,10024,27,210,16927
17,CAR,2,2016,CAR-16/HCF10/12/FSEC/NGO/3964,1760,2080,1920,2240,8000,1760,2080,1920,2240,8000
17,CAR,2,2016,CAR-16/HCF10/12/NUT-HLT/INGO/3994,1877,1953,3812,3970,11612,3399,4547,2177,1995,12118
17,CAR,2,2016,CAR-16/HCF10/12/HLT/INGO/4005,20424,4849,1765,1177,28215,24739,5874,2138,1425,34176
17,CAR,2,2016,CAR-16/HCF10/12/CCCM/NGO/4006,6001,6454,10009,8438,30902,5931,6424,10009,8438,30802
17,CAR,2,2016,CAR-16/HCF10/12/PROT/NGO/4013,3400,4600,7700,5700,21400,2800,6300,8400,6100,23600
17,CAR,2,2016,CAR-16/HCF10/12/LOG/INGO/4016,5341,5432,5297,5297,21367,1008,465,386,183,2042
17,CAR,2,2016,CAR-16/HCF10/12/CCCM/NGO/4018,1981,2292,4111,3960,12344,4516,4502,5589,5481,20088
17,CAR,2,2016,CAR-16/HCF10/12/NUT-HLT/INGO/4032,0,3096,3025,3277,9398,6843,7414,3324,3601,21182
17,CAR,2,2016,CAR-16/HCF10/12/ER-PROT-WaSH/INGO/4033,6720,6720,10080,10080,33600,17291,17235,26786,24041,85353
17,CAR,2,2016,CAR-16/HCF10/12/PROT-EDU/INGO/4057,1400,1800,1900,1900,7000,2133,2841,2001,2812,9787
17,CAR,2,2016,CAR-16/HCF10/12/FSEC-PROT/INGO/4062,1810,2950,1960,5290,12010,1907,2344,7940,5448,17639
17,CAR,2,2016,CAR-16/HCF10/12/ER-PROT/INGO/4067,4730,4928,4928,5125,19711,4494,5542,6711,5618,22365
17,CAR,2,2016,CAR-16/HCF10/12/EDU-PROT/INGO/4068,179,85,4771,3299,8334,181,80,3981,4419,8661
17,CAR,2,2016,CAR-16/HCF10/12/WaSH/INGO/4069,2685,3390,4425,4500,15000,4199,4212,3505,2751,14667
17,CAR,2,2016,CAR-16/HCF10/12/WaSH/INGO/4085,7136,8717,9119,9496,34468,6964,8292,8622,9286,33164
17,CAR,2,2016,CAR-16/HCF10/12/EDU/INGO/4092,62,28,2250,2250,4590,1635,1303,5231,3853,12022
17,CAR,2,2016,CAR-16/HCF10/12/WaSH/INGO/4093,3138,3745,7791,6969,21643,7340,7639,7952,8276,31207
17,CAR,2,2016,CAR-16/HCF10/12/HLT/INGO/4097,1148,1500,2206,2824,7678,1910,2604,1519,1486,7519
17,CAR,2,2016,CAR-16/HCF10/12/NUT/INGO/4099,83,5835,6954,7238,20110,81,5771,7053,6986,19891
17,CAR,2,2016,CAR-16/HCF10/12/FSEC/UN/4106,1350,2250,2250,3150,9000,3805,4123,4708,6184,18820
17,CAR,2,2016,CAR-16/HCF10/12/HLT-NUT/INGO/4108,14888,16450,12647,13133,57118,12316,12148,12212,12645,49321
17,CAR,2,2016,CAR-16/HCF10/12/WaSH/INGO/4111,13605,13013,17154,15379,59151,16602,17431,17236,17703,68972
17,CAR,1,2016,CAR-16/HCF10/R/FSEC/UN/4482,2537,2860,3503,3950,12850,2626,2960,3626,4088,13300
17,CAR,1,2017,CAR-17/HCF10/13/HLT/INGO/4640,2230,2660,3500,3810,12200,2022,3065,4345,3342,12774
17,CAR,1,2017,CAR-17/HCF10/13/WaSH-PROT/UN/4694,7000,7400,4900,5000,24300,6100,6400,4775,4289,21564
17,CAR,1,2017,CAR-17/HCF10/13/NFI/UN/4701,8092,8504,4053,4351,25000,16891,17947,8446,9501,52785
17,CAR,1,2017,CAR-17/HCF10/13/NFI-CCCM-PROT/UN/4710,7400,8810,9516,9514,35240,18241,21618,26219,26343,92421
17,CAR,1,2017,CAR-17/HCF10/13/LOG/INGO/4711,0,33,0,0,33,0,31,0,0,31
17,CAR,1,2017,CAR-17/HCF10/13/WaSH/INGO/4712,1906,2314,4900,4375,13495,6272,7102,13708,13504,40586
17,CAR,1,2017,CAR-17/HCF10/13/LOG/INGO/4713,440,458,423,440,1761,496,517,476,496,1985
17,CAR,1,2017,CAR-17/HCF10/13/WaSH/INGO/5365,8153,8486,7834,7527,32000,11014,9489,7426,8111,36040
17,CAR,1,2017,CAR-17/HCF10/13/NFI/INGO/5549,188,312,250,500,1250,159,263,211,422,1055
17,CAR,1,2017,CAR-17/HCF10/13/NFI/INGO/5567,391,437,433,389,1650,380,412,412,380,1584
17,CAR,2,2017,CAR-17/HCF10/AS1/LOG/INGO/5955,0,32,0,0,32,0,27,0,0,27
17,CAR,2,2017,CAR-17/HCF10/AS1/EDU-PROT/INGO/5956,1504,1583,2613,2813,8513,577,417,3801,3222,8017
17,CAR,2,2017,CAR-17/HCF10/AS1/FSEC-PROT-ER/INGO/5970,2760,2875,2875,2990,11500,3349,3489,3489,3629,13956
17,CAR,2,2017,CAR-17/HCF10/AS1/HLT/INGO/6007,10278,11140,2150,2331,25899,5189,6341,4693,4496,20719
17,CAR,2,2017,CAR-17/HCF10/AS1/PROT-EDU/INGO/6064,41,100,2500,3775,6416,240,79,5375,3754,9448
17,CAR,2,2017,CAR-17/HCF10/AS1/NUT-HLT/INGO/6090,7838,8667,8608,9034,34147,7810,8636,8580,9026,34052
17,CAR,2,2017,CAR-17/HCF10/AS1/EDU/UN/6115,140,93,5520,6480,12233,311,83,8830,9761,18985
17,CAR,1,2017,CAR-17/HCF10/13/HLT/INGO/6128,0,0,13475,11025,24500,0,0,14676,11531,26207
17,CAR,1,2017,CAR-17/HCF10/13/WaSH/UN/6129,79200,81600,38400,40800,240000,79200,81600,38400,40800,240000
17,CAR,2,2017,CAR-17/HCF10/AS1/LOG/UN/6150,1200,0,0,0,1200,513,0,0,0,513
17,CAR,2,2017,CAR-17/HCF10/AS1/FSEC/NGO/6160,1620,1980,1080,1320,6000,1620,1980,1080,1320,6000
17,CAR,2,2017,CAR-17/HCF10/AS1/EDU/NGO/6195,1216,2179,2874,2056,8325,1341,2449,3225,3437,10452
17,CAR,2,2017,CAR-17/HCF10/AS1/NUT-HLT/INGO/6202,6,54,1354,1526,2940,66,18,1516,1618,3218
17,CAR,2,2017,CAR-17/HCF10/AS1/NUT-HLT/INGO/6209,95,0,0,0,95,95,0,0,0,95
17,CAR,2,2017,CAR-17/HCF10/AS1/NFI/INGO/6210,564,947,670,670,2851,518,720,600,600,2438
17,CAR,2,2017,CAR-17/HCF10/AS1/WaSH/UN/6212,3300,3400,1600,1700,10000,5133,5289,2489,2644,15555
17,CAR,2,2017,CAR-17/HCF10/AS1/PROT/INGO/6213,135,90,0,0,225,136,65,0,0,201
17,CAR,2,2017,CAR-17/HCF10/AS1/WaSH/INGO/6221,2351,2447,3527,3675,12000,2478,2738,3782,4042,13040
17,CAR,2,2017,CAR-17/HCF10/AS1/LOG/INGO/6223,20,0,0,0,20,19,0,0,0,19
17,CAR,2,2017,CAR-17/HCF10/AS1/NUT-HLT/INGO/6226,2944,13814,6280,6536,29574,3688,7661,5978,6051,23378
17,CAR,2,2017,CAR-17/HCF10/AS1/WaSH/INGO/6227,27,27,0,0,54,37,14,0,0,51
17,CAR,2,2017,CAR-17/HCF10/AS1/WaSH/NGO/6228,4700,6700,3700,3900,19000,5300,7400,4000,4022,20722
17,CAR,2,2017,CAR-17/HCF10/AS1/FSEC-ER/INGO/6229,1175,1175,0,0,2350,1031,1319,0,0,2350
17,CAR,2,2017,CAR-17/HCF10/AS1/FSEC/INGO/6230,70,0,0,0,70,0,0,0,70,70
17,CAR,2,2017,CAR-17/HCF10/AS1/NFI/UN/6232,390,420,390,360,1560,405,416,379,371,1571
17,CAR,2,2017,CAR-17/HCF10/AS1/PROT/INGO/6236,10800,9000,5700,4500,30000,8269,1881,766,411,11327
17,CAR,2,2017,CAR-17/HCF10/AS1/WaSH-NFI/INGO/6237,2500,2600,2300,2600,10000,1676,1743,1542,1743,6704
17,CAR,1,2017,CAR-17/HCF10/RE17 HS/NUT-HLT/INGO/6578,6012,6512,1258,1362,15144,4003,4226,1918,2162,12309
17,CAR,1,2017,CAR-17/HCF10/RE17 HS/NUT-HLT/INGO/6601,58,1162,2443,2352,6015,395,8705,2069,2027,13196
17,CAR,1,2017,CAR-17/HCF10/RE17 HS/CCCM-PROT/UN/6607,8010,9536,10294,10302,38142,7094,8519,14553,14437,44603
17,CAR,1,2017,CAR-17/HCF10/RE17 HS/WaSH-PROT/INGO/6618,3792,5395,9004,9085,27276,5082,14220,7327,12118,38747
17,CAR,1,2017,CAR-17/HCF10/RE17 HS/WaSH/INGO/6619,4800,7920,5520,5760,24000,5982,7873,6040,6105,26000
17,CAR,1,2017,CAR-17/HCF10/RE17 HS/WaSH/INGO/6621,1800,1875,1875,1950,7500,4020,4188,4188,4354,16750
17,CAR,1,2017,CAR-17/HCF10/RE17 HS/LOG/UN/6736,40,0,0,0,40,13,0,0,0,13
17,CAR,1,2017,CAR-17/HCF10/13/CCCM/NGO/7331,2479,3458,5138,4734,15809,4023,5223,7192,6719,23157
17,CAR,1,2017,CAR-17/HCF10/13/WaSH/INGO/7332,15985,15290,20155,18069,69499,13769,13170,15564,17361,59864
17,CAR,2,2017,CAR-17/HCF10/AS2/EDU-PROT/INGO/7339,638,610,722,804,2774,864,1034,2997,2864,7759
17,CAR,2,2017,CAR-17/HCF10/AS2/FSEC-ER/NGO/7341,2350,2725,2130,2195,9400,2350,2725,2130,2195,9400
17,CAR,2,2017,CAR-17/HCF10/AS2/WaSH/INGO/7347,5142,5743,5668,5092,21645,0,0,0,0,0
17,CAR,2,2017,CAR-17/HCF10/AS2/NUT-HLT/INGO/7354,5588,6054,967,1047,13656,2145,4118,3103,4673,14039
17,CAR,2,2017,CAR-17/HCF10/AS2/WaSH/INGO/7361,3000,3000,6000,6000,18000,8391,9984,6755,7464,32594
17,CAR,2,2017,CAR-17/HCF10/AS2/PROT/INGO/7368,4603,6979,1794,2274,15650,1184,1161,78,120,2543
17,CAR,2,2017,CAR-17/HCF10/AS2/FSEC-PROT/INGO/7369,1580,7111,2372,4740,15803,3201,4715,747,544,9207
17,CAR,2,2017,CAR-17/HCF10/AS2/NUT-HLT/INGO/7370,6085,9065,6884,7433,29467,4832,7545,5061,5837,23275
17,CAR,2,2017,CAR-17/HCF10/AS2/NFI-PROT-FSEC/INGO/7371,3280,3005,3105,3231,12621,1324,1399,404,363,3490
17,CAR,2,2017,CAR-17/HCF10/AS2/NFI/INGO/7378,372,393,360,375,1500,0,0,0,0,0
17,CAR,2,2017,CAR-17/HCF10/AS2/ER/NGO/7379,110,120,130,140,500,101,128,119,160,508
17,CAR,2,2017,CAR-17/HCF10/AS2/PROT/INGO/7380,2400,2400,2400,2400,9600,1133,1110,1277,1049,4569
17,CAR,2,2017,CAR-17/HCF10/AS2/EDU/INGO/7385,170,100,7360,8640,16270,232,38,7442,8868,16580
17,CAR,2,2017,CAR-17/HCF10/AS2/NFI-FSEC-PROT/INGO/7391,460,612,920,1072,3064,65,86,129,151,431
17,CAR,2,2017,CAR-17/HCF10/AS2/EDU/UN/7393,22,22,1800,1200,3044,43,19,3730,3004,6796
17,CAR,2,2017,CAR-17/HCF10/AS2/NUT-HLT-WaSH/INGO/7394,5755,6361,5593,5822,23531,4644,8601,4675,4865,22785
17,CAR,2,2017,CAR-17/HCF10/AS2/PROT-EDU/INGO/7396,2080,2200,3270,3270,10820,791,834,1065,1029,3719
17,CAR,1,2018,CAR-18/HCF10/RA1/NFI/UN/8010,300,450,300,450,1500,260,600,250,350,1460
17,CAR,1,2018,CAR-18/HCF10/RA1/LOG/INGO/8014,0,20,0,0,20,0,9,0,0,9
17,CAR,1,2018,CAR-18/HCF10/RA1/PROT/UN/8017,1100,1060,9400,8840,20400,2432,1456,11439,7520,22847
17,CAR,1,2018,CAR-18/HCF10/RA1/HLT/INGO/8019,38610,39600,15257,16533,110000,39180,40780,16003,16657,112620
17,CAR,1,2018,CAR-18/HCF10/RA1/WaSH/INGO/8021,8153,10376,15141,19265,52935,20212,21038,0,0,41250
17,CAR,2,2018,CAR-18/HCF10/SA1/LOG/INGO/9000,0,23,0,0,23,0,23,0,0,23
17,CAR,2,2018,CAR-18/HCF10/SA1/NUT-HLT/INGO/9004,17094,18519,3576,3874,43063,3941,4982,3447,3772,16142
17,CAR,2,2018,CAR-18/HCF10/SA1/EDU-PROT/UN/9008,4040,8027,12500,12500,37067,12835,9337,18231,19517,59920
17,CAR,2,2018,CAR-18/HCF10/SA1/NUT/UN/9029,0,0,3961,4292,8253,0,0,0,0,0
17,CAR,2,2018,CAR-18/HCF10/SA1/HLT/INGO/9044,14746,12399,17207,17105,61457,5794,11406,6469,12074,35743
17,CAR,2,2018,CAR-18/HCF10/SA1/NUT-HLT/INGO/9075,15706,18364,8161,8842,51073,6761,9037,3812,4514,24124
17,CAR,2,2018,CAR-18/HCF10/SA1/WaSH/NGO/9078,1500,4200,2000,2500,10200,1400,3201,1091,1750,7442
17,CAR,2,2018,CAR-18/HCF10/SA1/NUT/UN/9106,0,0,2674,2896,5570,0,0,912,989,1901
17,CAR,2,2018,CAR-18/HCF10/SA1/ER-FSEC/INGO/9107,8820,9240,11760,12180,42000,1544,1944,4,8,3500
17,CAR,2,2018,CAR-18/HCF10/SA1/WaSH/INGO/9119,8749,9579,15555,15206,49089,4978,6039,21898,22565,55480
17,CAR,2,2018,CAR-18/HCF10/SA1/FSEC/UN/9142,5880,6120,8820,9180,30000,6370,6630,9555,9945,32500
17,CAR,2,2018,CAR-18/HCF10/SA1/HLT-NUT/NGO/9144,11,350,4008,4097,8466,17,427,2823,2823,6090
17,CAR,2,2018,CAR-18/HCF10/SA1/CCCM/NGO/9149,5900,7560,10553,9898,33911,5942,7961,10556,9910,34369
17,CAR,2,2018,CAR-18/HCF10/SA1/LOG/UN/9160,15,0,0,0,15,9,0,0,0,9
17,CAR,2,2018,CAR-18/HCF10/SA1/PROT/INGO/9162,6937,5032,1000,980,13949,7263,3672,1621,1648,14204
17,CAR,2,2018,CAR-18/HCF10/SA1/ER-WaSH/INGO/9163,3766,4359,8080,8795,25000,0,0,0,0,0
17,CAR,2,2018,CAR-18/HCF10/SA1/NFI-PROT/INGO/9164,6432,8240,15070,14320,44062,2520,4560,6340,8220,21640
17,CAR,2,2018,CAR-18/HCF10/SA1/LOG/INGO/9170,81,9,0,0,90,0,0,0,0,0
17,CAR,2,2018,CAR-18/HCF10/SA1/EDU/INGO/9172,28,28,6919,5759,12734,0,0,0,0,0
17,CAR,2,2018,CAR-18/HCF10/SA1/HLT/UN/9183,46158,48042,29553,33247,157000,18522,19278,11859,13341,63000
17,CAR,2,2018,CAR-18/HCF10/SA1/WaSH/INGO/9215,5812,6297,1458,1580,15147,1652,2094,1682,1917,7345
17,CAR,2,2018,CAR-18/HCF10/SA1/HLT-NUT/INGO/9550,95,0,0,0,95,95,0,0,0,95
52,Colombia,1,2015,COL-15/DDA-3418/DA/WASH/INGO/1742,718,648,287,327,1980,480,515,580,523,2098
52,Colombia,2,2015,COL-15/DDA-3418/SA/AL/NGO/1743,200,300,200,300,1000,169,180,131,90,570
52,Colombia,1,2015,COL-15/DDA-3418/DA/WASH-SAN-RT/INGO/1747,904,673,363,383,2323,751,565,489,525,2330
52,Colombia,2,2015,COL-15/DDA-3418/SA/SAN/NGO/2091,865,957,683,783,3288,868,895,761,773,3297
52,Colombia,2,2015,COL-15/DDA-3418/SA/SAN-WASH-Pr/INGO/2095,144,176,261,249,830,139,163,1411,1511,3224
52,Colombia,2,2015,COL-15/DDA-3418/SA/WASH-SAN-Pr/INGO/2097,147,178,201,144,670,135,157,199,200,691
52,Colombia,2,2016,COL-16/DDA-3418/SA/AL/INGO/2799,50,51,64,81,246,50,40,79,86,255
52,Colombia,2,2016,COL-16/DDA-3418/SA/Pr-WASH/INGO/2864,500,660,440,400,2000,500,660,440,400,2000
52,Colombia,2,2016,COL-16/DDA-3418/SA/WASH/INGO/2878,109,127,114,87,437,182,130,102,110,524
52,Colombia,2,2016,COL-16/DDA-3418/SA/WASH-SA/NGO/2881,528,571,610,602,2311,551,1028,975,985,3539
52,Colombia,1,2016,COL-16/DDA-3418/DA/WASH-SA-SAN/NGO/3140,196,244,202,184,826,339,377,310,342,1368
52,Colombia,2,2016,COL-16/DDA-3418/SA/E&E-Pr/INGO/3810,88,152,200,360,800,203,230,282,290,1005
52,Colombia,2,2016,COL-16/DDA-3418/SA/SAN-WASH/INGO/3900,900,1250,178,172,2500,813,1037,1102,1089,4041
52,Colombia,2,2016,COL-16/DDA-3418/SA/Pr-RT/INGO/3993,255,322,231,280,1088,243,249,220,210,922
52,Colombia,2,2016,COL-16/DDA-3418/SA/E&E-Pr/NGO/4029,270,302,155,131,858,473,484,291,334,1582
52,Colombia,2,2016,COL-16/DDA-3418/SA/E&E-WASH/INGO/4195,75,151,95,100,421,121,247,246,248,862
52,Colombia,2,2016,COL-16/DDA-3418/SA/WASH-SAN-Pr/NGO/4234,100,100,100,100,400,100,100,100,100,400
52,Colombia,1,2016,COL-16/DDA-3418/DA/SAN-AL-WASH/NGO/4367,504,374,393,411,1682,331,325,239,229,1124
52,Colombia,1,2017,COL-17/DDA-3418/DA/Pr-E&E-AL/INGO/5777,200,250,1275,1475,3200,662,1136,1881,1661,5340
52,Colombia,1,2017,COL-17/DDA-3418/DA/SAN-SA-Pr/NGO/5853,79,64,90,94,327,62,63,106,96,327
52,Colombia,1,2017,COL-17/DDA-3418/DA/WASH-SA-RT/NGO/6398,568,423,581,428,2000,760,694,316,340,2110
52,Colombia,2,2017,COL-17/DDA-3418/SA /WASH-Pr-SA/INGO/7004,604,580,339,327,1850,435,571,443,403,1852
52,Colombia,2,2017,COL-17/DDA-3418/SA /Pr-SA-WASH/NGO/7021,881,862,664,671,3078,881,862,664,671,3078
52,Colombia,2,2017,COL-17/DDA-3418/SA /RT-WASH-SA/NGO/7033,350,386,552,552,1840,350,386,552,552,1840
52,Colombia,2,2017,COL-17/DDA-3418/SA /SAN-WASH/INGO/7060,1020,1140,194,206,2560,582,1047,939,878,3446
52,Colombia,1,2017,COL-17/DDA-3418/DA/Pr/NGO/7657,44,92,44,44,224,59,117,80,134,390
24,DRC,1,2015,DRC-15/HCG10/PU/PROT/UN/2,4500,4860,1260,1380,12000,7751,11980,13864,13752,47347
24,DRC,1,2015,DRC-15/HCG10/PU/FSEC/NGO/3,890,1600,400,680,3570,890,1275,400,680,3245
24,DRC,1,2015,DRC-15/HCG10/R/FSEC/UN/4,4400,5600,0,0,10000,1703,3973,1450,3384,10510
24,DRC,1,2015,DRC-15/HCG10/R/FSEC/INGO/6,5270,5725,1740,1885,14620,4124,4292,3513,3655,15584
24,DRC,1,2015,DRC-15/HCG10/R/WaSH/NGO/7,2880,3120,4320,4680,15000,2880,3120,4320,4680,15000
24,DRC,1,2015,DRC-15/HCG10/R/FSEC/INGO/9,936,1908,355,401,3600,1596,1386,318,300,3600
24,DRC,1,2015,DRC-15/HCG10/R/FSEC/INGO/10,1341,1851,2552,2656,8400,1270,1153,2259,2083,6765
24,DRC,1,2015,DRC-15/HCG10/R/EDU/INGO/11,59,39,2340,3510,5948,80,47,2939,3087,6153
24,DRC,1,2015,DRC-15/HCG10/R/PROT/NGO/12,3000,3000,272,128,6400,4648,2252,240,160,7300
24,DRC,1,2015,DRC-15/HCG10/R/NFI/INGO/13,1380,1620,1800,2700,7500,1423,1479,2883,2972,8757
24,DRC,1,2015,DRC-15/HCG10/PU/HLT/UN/17,16025,18752,26527,25755,87059,13096,15040,21951,21407,71494
24,DRC,1,2015,DRC-15/HCG10/PU/FSEC/INGO/18,1080,1367,1753,1800,6000,0,0,0,0,0
24,DRC,1,2015,DRC-15/HCG10/PU/FSEC/INGO/19,540,683,877,900,3000,313,562,1002,946,2823
24,DRC,1,2015,DRC-15/HCG10/PU/NFI/NGO/20,1100,1900,1400,1600,6000,1142,4037,140,257,5576
24,DRC,1,2015,DRC-15/HCG10/R/FSEC/INGO/22,2281,3422,2177,2490,10370,1803,1579,3211,3759,10352
24,DRC,1,2015,DRC-15/HCG10/PU/WaSH/INGO/23,1270,1700,4164,4866,12000,0,0,0,0,0
24,DRC,2,2014,DRC-14/HCG10/PF1/FSEC-WaSH/INGO/26,4092,5001,6593,7048,22734,3412,4098,8672,8672,24854
24,DRC,2,2014,DRC-14/HCG10/PF1/FSEC-HLT-WaSH/NGO/27,5011,5429,15509,16801,42750,5678,6174,17553,19055,48460
24,DRC,2,2014,DRC-14/HCG10/PF1/FSEC-NUT-PROT/INGO/31,1055,1476,3194,3553,9278,1226,1805,3908,4263,11202
24,DRC,2,2014,DRC-14/HCG10/PF1/FSEC-HLT/INGO/32,9072,4212,3888,9828,27000,8445,4421,4092,10042,27000
24,DRC,2,2014,DRC-14/HCG10/PF1/FSEC-NFI/NGO/33,1200,2800,7200,8800,20000,1200,2800,7200,8800,20000
24,DRC,2,2014,DRC-14/HCG10/PF1/NFI-WaSH/INGO/34,2222,2222,11110,11110,26664,6063,6295,7351,8256,27965
24,DRC,2,2014,DRC-14/HCG10/PF1/HLT-PROT/INGO/35,233,590,285,372,1480,4509,5367,5008,5016,19900
24,DRC,2,2014,DRC-14/HCG10/PF1/FSEC-NUT/INGO/36,3920,4480,9520,10080,28000,4039,7107,14728,17646,43520
24,DRC,2,2014,DRC-14/HCG10/PF1/FSEC-NUT-WaSH/INGO/37,6313,12683,4127,4823,27946,6716,10201,6062,6682,29661
24,DRC,2,2014,DRC-14/HCG10/PF1/FSEC-NUT-PROT/INGO/38,2420,3629,3406,3144,12599,875,2392,3704,3955,10926
24,DRC,2,2014,DRC-14/HCG10/PF1/NUT-WaSH/INGO/39,23104,10991,2914,2891,39900,11185,6270,2384,2615,22454
24,DRC,2,2014,DRC-14/HCG10/PF1/FSEC-LOG-NFI/NGO/40,10530,26325,8775,12870,58500,175,2825,0,0,3000
24,DRC,2,2014,DRC-14/HCG10/PF1/FSEC-PROT-NFI/UN/41,17331,23290,20044,29427,90092,0,0,0,0,0
24,DRC,2,2014,DRC-14/HCG10/PF1/FSEC-NFI/UN/43,3000,2000,12500,12500,30000,1500,1000,3250,3250,9000
24,DRC,2,2014,DRC-14/HCG10/PF1/FSEC-NUT-WaSH/UN/44,8189,10644,9825,12282,40940,3546,4395,2528,2919,13388
24,DRC,1,2015,DRC-15/HCG10/PU/NFI/INGO/46,494,595,936,975,3000,736,701,1266,1338,4041
24,DRC,1,2015,DRC-15/HCG10/BUR/EDU/INGO/49,616,614,600,600,2430,554,903,2610,2445,6512
24,DRC,1,2015,DRC-15/HCG10/BUR/NFI/NGO/52,583,584,0,0,1167,452,556,685,926,2619
24,DRC,1,2015,DRC-15/HCG10/BUR/WaSH/INGO/53,10566,8812,10625,13730,43733,13608,15073,23521,21034,73236
24,DRC,1,2015,DRC-15/HCG10/PU2/HLT/NGO/55,0,0,182107,182106,364213,0,0,231688,231688,463376
24,DRC,1,2015,DRC-15/HCG10/PU2/HLT/INGO/56,0,0,57224,59560,116784,0,0,90821,94907,185728
24,DRC,1,2015,DRC-15/HCG10/PU2/HLT/INGO/57,0,0,110958,110958,221916,0,0,110958,110958,221916
24,DRC,1,2015,DRC-15/HCG10/PU2/HLT/INGO/58,0,0,22106,23010,45116,0,0,23101,23569,46670
24,DRC,1,2015,DRC-15/HCG10/R/HLT/INGO/73,5583,6424,8375,9636,30018,3672,4257,5821,6954,20704
24,DRC,1,2015,DRC-15/HCG10/R/WaSH/INGO/74,4909,7439,8809,10603,31760,4909,7439,8809,10603,31760
24,DRC,1,2015,DRC-15/HCG10/R/NFI/NGO/76,686,1428,2137,3250,7501,616,1299,1949,2976,6840
24,DRC,1,2015,DRC-15/HCG10/R/FSEC/INGO/77,6945,6945,0,0,13890,0,0,0,0,0
24,DRC,1,2015,DRC-15/HCG10/R/FSEC/NGO/79,952,1048,1905,2095,6000,948,1045,1911,2096,6000
24,DRC,1,2015,DRC-15/HCG10/PU3/PROT/INGO/82,3870,4730,5805,7095,21500,3506,1374,5805,7095,17780
24,DRC,1,2015,DRC-15/HCG10/PU3/HLT/NGO/83,2548,2744,7777,8712,21781,5775,6248,6256,6788,25067
24,DRC,1,2015,DRC-15/HCG10/PU3/EDU/INGO/85,0,0,2812,2134,4946,105,26,2720,1781,4632
24,DRC,1,2015,DRC-15/HCG10/PU3/PROT/NGO/86,150,150,50,50,400,285,327,125,117,854
24,DRC,1,2015,DRC-15/HCG10/PU3/NUT/INGO/87,0,0,2130,2130,4260,0,0,2258,2381,4639
24,DRC,1,2015,DRC-15/HCG10/R/LOG/INGO/94,10720,12552,21494,19770,64536,10720,12552,21494,19770,64536
24,DRC,1,2015,DRC-15/HCG10/R/FSEC/INGO/96,1495,1750,2998,2757,9000,4583,4403,0,0,8986
24,DRC,2,2014,DRC-14/HCG10/PF1/NUT-FSEC-WaSH/NGO/98,6461,7373,7391,10105,31330,5169,6636,5913,8084,25802
24,DRC,1,2015,DRC-15/HCG10/PU/NUT/INGO/99,0,132,420,420,972,0,9,877,620,1506
24,DRC,1,2015,DRC-15/HCG10/R/NUT/INGO/100,303,3517,4019,4186,12025,1145,5119,6129,6894,19287
24,DRC,1,2015,DRC-15/HCG10/R/HLT/INGO/102,13000,19500,12000,18000,62500,17531,18797,10926,17086,64340
24,DRC,1,2015,DRC-15/HCG10/R/EDU/NGO/103,140,84,2940,2714,5878,171,53,3070,2720,6014
24,DRC,1,2015,DRC-15/HCG10/R/NFI/NGO/104,300,350,50,53,753,1013,2135,2609,3012,8769
24,DRC,1,2015,DRC-15/HCG10/PU/LOG/INGO/109,149936,155431,0,0,305367,149936,155431,0,0,305367
24,DRC,1,2015,DRC-15/HCG10/PU/WaSH/INGO/110,5380,5600,9320,9700,30000,5380,5600,9320,9700,30000
24,DRC,1,2015,DRC-15/HCG10/R/FSEC/NGO/116,50,650,0,0,700,157,843,1618,1892,4510
24,DRC,1,2015,DRC-15/HCG10/R/WaSH/NGO/117,6240,9360,6760,10140,32500,6010,9016,6224,9250,30500
24,DRC,1,2015,DRC-15/HCG10/R/EDU/INGO/118,552,495,1432,1414,3893,663,601,1291,1214,3769
24,DRC,1,2015,DRC-15/HCG10/R/NFI/INGO/120,4897,5317,8675,8142,27031,4762,5535,8741,8366,27404
24,DRC,1,2015,DRC-15/HCG10/R/NFI/NGO/121,3030,4125,1133,1542,9830,5605,7632,2096,2852,18185
24,DRC,2,2014,DRC-14/HCG10/PF1/WaSH-FSEC/INGO/123,5103,4617,7533,7047,24300,5190,4696,7661,7167,24714
24,DRC,2,2014,DRC-14/HCG10/PF1/PROT-EDU/UN/124,418,376,4410,3870,9074,417,246,6595,4867,12125
24,DRC,1,2015,DRC-15/HCG10/PS/NFI-WaSH-COORD-EDU-HLT/UN/128,54899,59890,64880,69870,249539,123455,134678,145901,157124,561158
24,DRC,1,2015,DRC-15/HCG10/R/NFI/NGO/130,2460,3148,3215,2096,10919,3162,3850,3780,4239,15031
24,DRC,1,2016,DRC-16/HCG10/PS/COORD-NFI-WaSH-HLT-EDU/UN/134,35306,38248,41446,44900,159900,36491,39532,51392,54304,181719
24,DRC,1,2015,DRC-15/HCG10/R/FSEC/INGO/137,1428,1609,2056,2107,7200,1428,1609,2056,2107,7200
24,DRC,1,2015,DRC-15/HCG10/R/NFI/NGO/138,640,2560,0,0,3200,155,3045,0,0,3200
24,DRC,1,2015,DRC-15/HCG10/R/FSEC/NGO/141,1233,1482,1540,1751,6006,1226,1457,1552,1773,6008
24,DRC,1,2016,DRC-16/HCG10/PU02/NFI/NGO/143,2000,3050,300,400,5750,767,1069,901,1410,4147
24,DRC,1,2016,DRC-16/HCG10/PU02/HLT/INGO/145,427,494,107,122,1150,448,499,366,347,1660
24,DRC,1,2016,DRC-16/HCG10/PU02/WaSH-NFI/INGO/146,15200,22800,0,0,38000,13394,23741,3026,5234,45395
24,DRC,1,2016,DRC-16/HCG10/PU02/HLT-WaSH-COORD/UN/147,5,0,0,0,5,6,0,0,0,6
24,DRC,1,2016,DRC-16/HCG10/PU02/WaSH/INGO/148,21475,23987,5152,5636,56250,28634,31983,6871,7512,75000
24,DRC,1,2016,DRC-16/HCG10/PU02/HLT/INGO/149,800,803,252,262,2117,1104,1143,331,279,2857
24,DRC,2,2016,DRC-16/HCG10/ST1/LOG-EDU-PROT/INGO/159,6500,6500,7500,7500,28000,2371,1942,6275,5504,16092
24,DRC,2,2016,DRC-16/HCG10/ST1/FSEC/NGO/166,1000,1000,0,0,2000,1000,1000,0,0,2000
24,DRC,2,2016,DRC-16/HCG10/ST1/HLT-NUT-PROT/INGO/170,3361,5483,3945,4631,17420,3641,5108,8331,8984,26064
24,DRC,2,2016,DRC-16/HCG10/ST1/WaSH/INGO/171,2346,2594,3458,3952,12350,1400,1609,1439,1803,6251
24,DRC,2,2016,DRC-16/HCG10/ST1/FSEC-NUT-HLT-PROT/INGO/175,8206,10645,8464,9647,36962,1596,1885,2526,2765,8772
24,DRC,2,2016,DRC-16/HCG10/ST1/FSEC-EDU/NGO/193,704,1056,5650,5650,13060,1062,774,6176,5626,13638
24,DRC,2,2016,DRC-16/HCG10/ST1/WaSH-LOG/INGO/202,7752,8183,13351,13782,43068,3793,3532,6278,6082,19685
24,DRC,2,2016,DRC-16/HCG10/ST2/FSEC-EDU/NGO/3925,500,750,5625,5625,12500,500,750,5799,6464,13513
24,DRC,2,2016,DRC-16/HCG10/ST2/NUT-FSEC/INGO/3973,3517,5289,3202,4022,16030,4507,5100,4156,5948,19711
24,DRC,2,2016,DRC-16/HCG10/ST2/EDU/NGO/4065,131,37,2921,1864,4953,131,37,2921,1854,4943
24,DRC,2,2016,DRC-16/HCG10/ST2/NUT-HLT/INGO/4132,10632,12187,6172,9372,38363,10428,11748,5458,7086,34720
24,DRC,2,2016,DRC-16/HCG10/ST2/HLT-WaSH/INGO/4137,6695,8498,5150,5408,25751,4897,6438,7100,8166,26601
24,DRC,2,2016,DRC-16/HCG10/ST2/LOG-WaSH/INGO/4142,5120,6927,8433,9637,30117,14125,11677,10400,9282,45484
24,DRC,1,2016,DRC-16/HCG10/PU03/HLT/INGO/4329,960,1440,320,480,3200,787,848,521,460,2616
24,DRC,1,2016,DRC-16/HCG10/UR03/NFI/NGO/4334,4883,5153,8409,8680,27125,4352,5269,11161,11926,32708
24,DRC,1,2016,DRC-16/HCG10/UR03/PROT/NGO/4335,0,0,110,90,200,0,0,177,64,241
24,DRC,1,2016,DRC-16/HCG10/UR03/MSREF/INGO/4336,5604,5604,5604,5604,22416,4902,6721,4291,8423,24337
24,DRC,1,2016,DRC-16/HCG10/UR02/FSEC/INGO/4341,3193,4407,6076,6324,20000,5622,6267,7200,6307,25396
24,DRC,1,2016,DRC-16/HCG10/UR03/PROT/INGO/4342,146610,179190,97740,119460,543000,21991,35838,10751,10751,79331
24,DRC,1,2016,DRC-16/HCG10/UR02/NFI/NGO/4346,400,1600,0,0,2000,37,1963,0,0,2000
24,DRC,1,2016,DRC-16/HCG10/UR02/HLT/INGO/4347,27707,12864,11874,30015,82460,32100,34775,7481,8104,82460
24,DRC,1,2016,DRC-16/HCG10/UR02/FSEC/INGO/4348,1474,1907,2774,2515,8670,1713,1852,2283,2301,8149
24,DRC,1,2016,DRC-16/HCG10/UR03/PROT-HLT/INGO/4349,6226,8878,6516,7877,29497,4216,10666,4879,5497,25258
24,DRC,1,2016,DRC-16/HCG10/UR02/EDU/INGO/4350,180,116,3150,3150,6596,211,63,3748,3557,7579
24,DRC,1,2016,DRC-16/HCG10/UR03/EDU/INGO/4354,2028,1854,4300,4300,12482,1027,3462,5414,5270,15173
24,DRC,1,2016,DRC-16/HCG10/UR03/NFI-FSEC/INGO/4356,8194,12287,8535,9624,38640,7860,8051,16273,16700,48884
24,DRC,1,2016,DRC-16/HCG10/UR02/EDU/INGO/4359,450,250,1800,1200,3700,502,318,2635,2890,6345
24,DRC,1,2016,DRC-16/HCG10/UR03/HLT/INGO/4360,16692,17888,15960,15960,66500,10107,16497,7424,7912,41940
24,DRC,1,2016,DRC-16/HCG10/UR03/HLT-PROT/INGO/4363,45380,55464,9961,12175,122980,45380,55464,9961,12175,122980
24,DRC,1,2016,DRC-16/HCG10/UR02/HLT/INGO/4365,8637,9356,12958,14049,45000,5756,14123,7871,9048,36798
24,DRC,1,2016,DRC-16/HCG10/UR01/HLT/INGO/4366,5174,5386,5834,5606,22000,3293,5922,3328,3536,16079
24,DRC,1,2016,DRC-16/HCG10/UR03/PROT/NGO/4369,80,80,418,225,803,176,66,356,214,812
24,DRC,1,2016,DRC-16/HCG10/UR03/FSEC/NGO/4385,2050,29150,454,141,31795,2050,29150,454,141,31795
24,DRC,1,2016,DRC-16/HCG10/UR03/NFI-FSEC/NGO/4386,7200,10800,17820,36180,72000,7200,10800,17820,36180,72000
24,DRC,1,2016,DRC-16/HCG10/UR02/PROT/NGO/4387,340,265,29071,19369,49045,310,234,27094,23002,50640
24,DRC,1,2016,DRC-16/HCG10/UR02/NUT/INGO/4389,216,64,1000,1015,2295,207,80,1089,1285,2661
24,DRC,1,2016,DRC-16/HCG10/UR03/WaSH/NGO/4391,9545,6818,11364,17727,45454,9260,11428,11708,16518,48914
24,DRC,1,2016,DRC-16/HCG10/UR01/EDU/NGO/4392,50,20,2250,2250,4570,85,16,2464,2135,4700
24,DRC,1,2016,DRC-16/HCG10/UR01/PROT/NGO/4393,95,85,115,115,410,111,69,206,106,492
24,DRC,1,2016,DRC-16/HCG10/UR03/EDU/NGO/4395,174,85,3654,2646,6559,0,0,0,0,0
24,DRC,1,2016,DRC-16/HCG10/UR03/WaSH/NGO/4397,5453,6831,11618,13556,37458,5098,6227,13771,13015,38111
24,DRC,1,2016,DRC-16/HCG10/UR01/NUT-WaSH/INGO/4400,1664,1566,2206,2264,7700,632,544,567,573,2316
24,DRC,1,2016,DRC-16/HCG10/UR03/LOG-PROT/INGO/4401,525,0,0,0,525,887,0,0,0,887
24,DRC,1,2016,DRC-16/HCG10/UR03/HLT-FSEC-PROT/INGO/4402,24305,28533,0,0,52838,12417,19576,12003,15429,59425
24,DRC,1,2016,DRC-16/HCG10/UR03/WaSH/INGO/4403,18900,21600,22500,27000,90000,16522,18940,19609,23195,78266
24,DRC,1,2016,DRC-16/HCG10/UR02/HLT-NUT/INGO/4404,4319,4495,5964,6208,20986,4234,6897,8978,5407,25516
24,DRC,1,2016,DRC-16/HCG10/UR02/PROT/NGO/4406,25,150,5,70,250,20,278,0,58,356
24,DRC,1,2016,DRC-16/HCG10/UR02/EDU/NGO/4407,181,89,3190,2310,5770,0,0,0,0,0
24,DRC,1,2016,DRC-16/HCG10/UR02/PROT/NGO/4411,4569,7934,3365,3966,19834,5400,8785,3383,3100,20668
24,DRC,1,2016,DRC-16/HCG10/UR02/WaSH-LOG/NGO/4415,38223,38223,38223,38226,152895,41251,41572,42685,43326,168834
24,DRC,1,2016,DRC-16/HCG10/UR02/LOG-NFI/NGO/4416,675,1110,1825,2490,6100,675,1110,1825,2490,6100
24,DRC,1,2016,DRC-16/HCG10/UR03/WaSH/NGO/4418,8086,10571,8043,11000,37700,9694,12020,11196,12526,45436
24,DRC,1,2016,DRC-16/HCG10/UR01/LOG-NFI-WaSH/INGO/4434,4064,4472,6108,5399,20043,5624,8295,4892,5723,24534
24,DRC,1,2016,DRC-16/HCG10/PS/COORD/UN/4624,4,4,4,4,16,1,1,1,1,4
24,DRC,1,2017,DRC-17/HCG10/UR1/EDU/INGO/5564,1559,1559,8190,8190,19498,1813,1621,7587,7141,18162
24,DRC,1,2017,DRC-17/HCG10/UR1/PROT/NGO/5605,0,0,18765,12530,31295,0,0,13681,11999,25680
24,DRC,1,2017,DRC-17/HCG10/UR1/WaSH/NGO/5695,4180,8110,9152,11020,32462,7480,11129,8213,9669,36491
24,DRC,1,2017,DRC-17/HCG10/UR1/PROT/NGO/5697,592,441,172,163,1368,200,283,170,160,813
24,DRC,2,2017,DRC-17/HCG10/ST1/NUT-PROT-WaSH-FSEC/INGO/5702,7275,16464,10112,10234,44085,0,0,0,0,0
24,DRC,1,2017,DRC-17/HCG10/UR1/NFI/NGO/5710,4200,6800,13620,15380,40000,5467,3759,13774,16329,39329
24,DRC,2,2017,DRC-17/HCG10/ST1/LOG-WaSH-PROT/NGO/5849,1120,1550,1250,1200,5120,723,543,621,376,2263
24,DRC,2,2017,DRC-17/HCG10/ST1/HLT-PROT-EDU/INGO/5850,1245,2816,6064,9203,19328,417,842,2089,3905,7253
24,DRC,1,2017,DRC-17/HCG10/PU1/LOG-PROT/INGO/6284,1208,1177,250,150,2785,1183,2043,705,1219,5150
24,DRC,1,2017,DRC-17/HCG10/UR2/EDU-PROT/INGO/6653,580,440,10000,10000,21020,684,884,8903,9684,20155
24,DRC,1,2017,DRC-17/HCG10/UR2/PROT/INGO/6656,0,0,1978,1574,3552,0,0,861,1215,2076
24,DRC,1,2017,DRC-17/HCG10/UR2/EDU-PROT/NGO/6687,369,363,4800,4800,10332,396,368,5485,4250,10499
24,DRC,1,2017,DRC-17/HCG10/PU1/PROT/NGO/6881,9082,9838,7430,8050,34400,14681,13413,10274,9866,48234
24,DRC,1,2017,DRC-17/HCG10/UR4/LOG/UN/7405,600,600,0,0,1200,106,106,0,0,212
24,DRC,1,2017,DRC-17/HCG10/UR5/LOG/INGO/7426,4320,2880,17640,18360,43200,2960,4539,0,0,7499
24,DRC,1,2017,DRC-17/HCG10/UR5/FSEC/NGO/7428,1000,1800,6200,7800,16800,1000,1800,6200,7800,16800
24,DRC,1,2017,DRC-17/HCG10/UR5/NFI/NGO/7430,12348,49392,252,1008,63000,3320,39786,2842,17052,63000
24,DRC,1,2017,DRC-17/HCG10/UR5/FSEC/INGO/7431,2772,3828,2904,3696,13200,1690,2366,4683,4227,12966
24,DRC,1,2017,DRC-17/HCG10/UR5/NFI/INGO/7432,10186,10186,15279,15279,50930,0,0,0,0,0
24,DRC,1,2017,DRC-17/HCG10/UR5/WaSH/NGO/7433,7594,10125,20883,24681,63283,4589,4968,25982,27844,63383
24,DRC,1,2017,DRC-17/HCG10/UR5/PROT/INGO/7438,939,1190,1205,1384,4718,1306,1671,1682,1594,6253
24,DRC,1,2017,DRC-17/HCG10/UR5/HLT/NGO/7439,536,4300,6027,6848,17711,722,4518,6459,7011,18710
24,DRC,1,2017,DRC-17/HCG10/UR3/NUT/UN/7443,0,0,32160,34840,67000,0,0,3126,3315,6441
24,DRC,1,2017,DRC-17/HCG10/UR5/LOG/INGO/7448,368,32,0,0,400,653,230,0,0,883
24,DRC,1,2017,DRC-17/HCG10/UR5/NFI/NGO/7451,5800,9600,13640,10960,40000,5800,9600,13640,10960,40000
24,DRC,1,2017,DRC-17/HCG10/UR5/WaSH/NGO/7462,6903,7478,7478,8101,29960,6903,7478,7478,8101,29960
24,DRC,1,2017,DRC-17/HCG10/UR5/FSEC/INGO/7465,1760,2640,0,0,4400,1760,2640,0,0,4400
24,DRC,1,2017,DRC-17/HCG10/UR5/FSEC/INGO/7466,5166,5597,6815,8672,26250,9185,10908,3339,3660,27092
24,DRC,1,2017,DRC-17/HCG10/UR5/PROT/NGO/7470,292,238,60,70,660,382,207,55,77,721
24,DRC,1,2017,DRC-17/HCG10/UR5/HLT/INGO/7482,14831,16066,3601,3601,38099,11969,20205,6565,8817,47556
24,DRC,1,2017,DRC-17/HCG10/UR5/FSEC/NGO/7486,12000,12960,11040,12000,48000,12000,12960,11040,12000,48000
24,DRC,1,2017,DRC-17/HCG10/UR5/FSEC/NGO/7498,6820,7720,4564,5146,24250,4484,4557,8124,7948,25113
24,DRC,1,2017,DRC-17/HCG10/UR5/FSEC/NGO/7500,3120,5280,5040,7560,21000,3120,5280,5040,7560,21000
24,DRC,1,2017,DRC-17/HCG10/UR5/FSEC/NGO/7506,4038,6733,6733,9419,26923,4233,6749,6825,9572,27379
24,DRC,1,2017,DRC-17/HCG10/UR5/NUT/INGO/7508,0,0,2000,2400,4400,0,0,663,1668,2331
24,DRC,1,2017,DRC-17/HCG10/UR5/WaSH/NGO/7511,11979,14642,18635,21297,66553,11480,15532,18908,21609,67529
24,DRC,1,2017,DRC-17/HCG10/UR5/FSEC/INGO/7526,4680,9540,1800,1980,18000,865,2135,9622,9060,21682
24,DRC,1,2017,DRC-17/HCG10/UR5/FSEC/NGO/7542,2700,2927,2395,3300,11322,2762,3151,2564,3367,11844
24,DRC,1,2017,DRC-17/HCG10/UR5/FSEC/INGO/7543,3208,7485,2733,6376,19802,3208,7485,2733,6376,19802
24,DRC,1,2017,DRC-17/HCG10/UR5/WaSH/INGO/7547,25064,28644,29838,35806,119352,10205,11818,12473,13997,48493
24,DRC,1,2017,DRC-17/HCG10/UR5/FSEC/INGO/7559,3982,3982,3981,3982,15927,2450,3676,4901,7352,18379
24,DRC,1,2017,DRC-17/HCG10/UR5/PROT/INGO/7568,25000,26000,30000,30000,111000,763,624,2260,1850,5497
24,DRC,1,2018,DRC-18/HCG10/UR1/EDU-PROT/NGO/8769,2085,2088,1993,1994,8160,2128,2203,1974,1984,8289
24,DRC,1,2018,DRC-18/HCG10/UR1/FSEC/INGO/8770,3094,3712,6806,7013,20625,0,0,0,0,0
24,DRC,1,2018,DRC-18/HCG10/UR1/PROT/NGO/8772,3127,3387,2558,2772,11844,3911,4159,2027,1643,11740
24,DRC,1,2018,DRC-18/HCG10/UR1/NFI/NGO/8773,920,2330,3377,3763,10390,1323,1495,4980,5293,13091
24,DRC,1,2018,DRC-18/HCG10/UR1/NFI/NGO/8774,1800,2700,8100,9900,22500,1800,2700,8100,9900,22500
24,DRC,1,2018,DRC-18/HCG10/UR1/NUT/INGO/8775,0,0,480,488,968,0,0,254,343,597
24,DRC,1,2018,DRC-18/HCG10/UR1/EDU-PROT/INGO/8776,130,82,1270,1270,2752,37,11,360,360,768
24,DRC,1,2018,DRC-18/HCG10/UR1/FSEC/INGO/8777,4238,9891,523,1223,15875,4238,9891,523,1223,15875
24,DRC,1,2018,DRC-18/HCG10/UR1/EDU/NGO/8778,196,35,4912,4912,10055,190,41,4223,3327,7781
24,DRC,1,2018,DRC-18/HCG10/UR1/FSEC/NGO/8780,981,1061,857,1185,4084,713,788,1302,1431,4234
24,DRC,1,2018,DRC-18/HCG10/UR1/HLT/INGO/8782,1878,2035,2877,3116,9906,565,1795,1062,2172,5594
24,DRC,1,2018,DRC-18/HCG10/UR1/NUT/NGO/8783,0,123,8157,9199,17479,0,41,3301,4012,7354
24,DRC,1,2018,DRC-18/HCG10/UR1/FSEC/INGO/8786,2333,2527,1987,2153,9000,2333,2527,1987,2153,9000
24,DRC,1,2018,DRC-18/HCG10/UR1/HLT/INGO/8788,4787,5585,4388,5186,19946,7006,11992,1115,1199,21312
24,DRC,1,2018,DRC-18/HCG10/UR1/EDU/INGO/8789,277,162,1131,738,2308,0,0,0,0,0
24,DRC,1,2018,DRC-18/HCG10/UR1/WaSH/NGO/8790,983,2063,2947,3831,9824,639,1278,1915,2554,6386
24,DRC,1,2018,DRC-18/HCG10/UR1/HLT/INGO/8791,4085,4408,3342,3606,15441,541,762,1688,1178,4169
24,DRC,1,2018,DRC-18/HCG10/UR1/FSEC/NGO/8792,4012,8024,5350,9361,26747,2296,6686,5357,7528,21867
24,DRC,1,2018,DRC-18/HCG10/UR1/FSEC/NGO/8793,1640,2160,8632,9488,21920,1640,2160,8632,9488,21920
24,DRC,1,2018,DRC-18/HCG10/UR1/NFI/NGO/8796,2970,3630,4455,5445,16500,1719,2664,4607,4586,13576
24,DRC,1,2018,DRC-18/HCG10/UR1/NUT/INGO/8797,10,76,2588,2390,5064,0,0,107,114,221
24,DRC,1,2018,DRC-18/HCG10/UR1/LOG/NGO/8798,2189,2962,3606,4121,12878,2189,2962,3606,4121,12878
24,DRC,1,2018,DRC-18/HCG10/UR1/HLT/INGO/8799,14653,17202,0,0,31855,2561,2901,0,0,5462
24,DRC,1,2018,DRC-18/HCG10/UR1/WaSH/NGO/8800,2487,2557,2237,2591,9872,2485,2560,2244,2597,9886
24,DRC,1,2018,DRC-18/HCG10/UR1/EDU/INGO/8804,0,0,3219,3781,7000,0,0,2057,2045,4102
24,DRC,1,2018,DRC-18/HCG10/UR1/HLT/INGO/8805,5236,6373,5463,5690,22762,1869,2456,2309,2803,9437
24,DRC,1,2018,DRC-18/HCG10/UR1/PROT/NGO/8806,12566,20819,6505,3483,43373,12566,20819,6505,3483,43373
24,DRC,1,2018,DRC-18/HCG10/UR1/HLT/NGO/8808,4691,13069,16361,18138,52259,0,6329,15188,16453,37970
24,DRC,1,2018,DRC-18/HCG10/UR1/WaSH/NGO/8809,977,1058,854,1180,4069,1472,1595,1288,1779,6134
24,DRC,1,2018,DRC-18/HCG10/UR1/LOG/INGO/8810,3,3,4,4,14,16,0,0,0,16
24,DRC,1,2018,DRC-18/HCG10/UR1/FSEC/INGO/8819,1465,1465,2929,2928,8787,1424,3321,1213,2829,8787
24,DRC,1,2018,DRC-18/HCG10/UR1/PROT/NGO/8847,51950,77925,17317,25975,173167,41560,62340,13854,20780,138534
24,DRC,1,2018,DRC-18/HCG10/UR1/LOG/NGO/8855,811,1336,1098,1527,4772,811,1336,1098,1527,4772
24,DRC,1,2018,DRC-18/HCG10/UR1/WaSH/INGO/8856,9746,10913,7057,14291,42007,0,0,0,0,0
24,DRC,1,2018,DRC-18/HCG10/UR1/NUT/INGO/8864,0,540,1630,2444,4614,0,58,753,496,1307
24,DRC,1,2018,DRC-18/HCG10/UR1/FSEC/NGO/8871,1959,2938,4847,9841,19585,1959,2938,4847,9841,19585
24,DRC,1,2018,DRC-18/HCG10/UR1/HLT/INGO/8887,22770,27416,4998,6019,61203,1501,1934,1273,1719,6427
24,DRC,1,2018,DRC-18/HCG10/UR1/LOG/INGO/8890,2,2,0,0,4,0,0,0,0,0
24,DRC,1,2018,DRC-18/HCG10/UR1/NFI/INGO/8891,3414,3626,5122,5438,17600,0,0,0,0,0
24,DRC,1,2018,DRC-18/HCG10/UR1/PROT/INGO/8896,4386,4642,1909,2187,13124,3149,3862,5450,4436,16897
24,DRC,1,2018,DRC-18/HCG10/UR1/HLT-NUT/INGO/8899,5417,5918,1475,1663,14473,1543,4212,788,976,7519
24,DRC,1,2018,DRC-18/HCG10/UR1/EDU/INGO/8908,39,10,1050,1050,2149,37,12,1015,894,1958
24,DRC,1,2018,DRC-18/HCG10/UR1/HLT/INGO/8956,12067,13073,2754,3106,31000,3502,5504,1181,1651,11838
24,DRC,1,2018,DRC-18/HCG10/UR1/WaSH/NGO/8957,16604,24907,17988,26983,86482,10668,21143,7179,11419,50409
24,DRC,1,2018,DRC-18/HCG10/UR1/PROT/INGO/8958,4431,6193,4834,6272,21730,1780,1971,2928,3043,9722
24,DRC,1,2018,DRC-18/HCG10/UR3/WaSH/INGO/9247,4084,4514,6236,6666,21500,57,63,87,93,300
24,DRC,1,2018,DRC-18/HCG10/UR3/LOG-WaSH/NGO/9294,7533,10191,12407,14180,44311,3622,4900,5965,6817,21304
24,DRC,1,2018,DRC-18/HCG10/UR3/FSEC/INGO/9312,600,1400,3840,6160,12000,1867,2378,5329,4610,14184
24,DRC,1,2018,DRC-18/HCG10/UR3/NFI/NGO/9337,2347,2833,4325,4689,14194,2097,2577,5562,6682,16918
24,DRC,1,2018,DRC-18/HCG10/PU1/HLT/NGO/10136,6338,7006,9674,10342,33360,31042,35228,64153,64429,194852
53,Ethiopia,2,2015,ETH-15/DDA-3379/CP/WASH/INGO/1735,4322,4969,437,438,10166,190,5947,2933,3043,12113
53,Ethiopia,2,2015,ETH-15/DDA-3379/CP/WASH/INGO/1738,26055,31845,0,0,57900,28752,35142,0,0,63894
53,Ethiopia,2,2015,ETH-15/DDA-3379/CP/A/INGO/1766,4156,5348,4019,4324,17847,5687,11621,15024,16028,48360
53,Ethiopia,2,2015,ETH-15/DDA-3379/CP/N/INGO/1783,0,487,358,365,1210,0,437,366,415,1218
53,Ethiopia,2,2015,ETH-15/DDA-3379/CP/WASH/INGO/1806,0,10670,8335,8676,27681,0,10267,6017,7354,23638
53,Ethiopia,2,2015,ETH-15/DDA-3379/CP/N/INGO/1813,0,6277,3833,3682,13792,0,7326,4377,4558,16261
53,Ethiopia,2,2015,ETH-15/DDA-3379/CP/N-WASH-A/INGO/1843,49674,39030,8279,8617,105600,49674,39030,8279,8617,105600
53,Ethiopia,2,2015,ETH-15/DDA-3379/CP/FSL-N-WASH/INGO/1865,11151,12081,6273,6795,36300,11597,12345,6360,7108,37410
53,Ethiopia,2,2015,ETH-15/DDA-3379/CP/N-WASH/INGO/1929,8503,17163,10676,10676,47018,8637,11415,13558,13450,47060
53,Ethiopia,2,2015,ETH-15/DDA-3379/CP/N-WASH/INGO/1938,0,2890,1416,1474,5780,0,3881,752,711,5344
53,Ethiopia,2,2015,ETH-15/DDA-3379/CP/FSL-N-WASH/INGO/1941,12368,13398,6957,7537,40260,12628,13680,7103,7695,41106
53,Ethiopia,2,2015,ETH-15/DDA-3379/CP/H/UN/1952,0,0,2707767,2601580,5309347,0,0,2820519,2709910,5530429
53,Ethiopia,2,2015,ETH-15/DDA-3379/CP/N/INGO/1953,0,4816,6803,7082,18701,0,13863,4555,4023,22441
53,Ethiopia,2,2015,ETH-15/DDA-3379/CP/N/INGO/1960,0,6602,5972,6215,18789,0,6385,7615,7297,21297
53,Ethiopia,2,2015,ETH-15/DDA-3379/CP/N/INGO/2046,0,1936,2089,2175,6200,0,2552,2580,2646,7778
53,Ethiopia,2,2015,ETH-15/DDA-3379/CP/CSS/UN/2067,200,200,0,0,400,396,355,0,0,751
53,Ethiopia,2,2015,ETH-15/DDA-3379/CP/N/INGO/2068,0,21920,11838,12321,46079,0,15789,8762,10639,35190
53,Ethiopia,2,2015,ETH-15/DDA-3379/CP/N/INGO/2071,0,4015,653,680,5348,0,5284,850,947,7081
53,Ethiopia,2,2015,ETH-15/DDA-3379/CP/N/INGO/2072,0,5248,1025,1066,7339,5480,13260,1612,2417,22769
53,Ethiopia,2,2015,ETH-15/DDA-3379/CP/FSL/INGO/2073,27750,9250,0,0,37000,97807,25897,0,0,123704
53,Ethiopia,2,2015,ETH-15/DDA-3379/RB/N/INGO/2098,0,45199,16644,16644,78487,0,44385,15603,15763,75751
53,Ethiopia,2,2015,ETH-15/DDA-3379/RB/WASH/INGO/2101,17488,20786,28535,29956,96765,31344,22761,20674,19619,94398
53,Ethiopia,2,2015,ETH-15/DDA-3379/RB/WASH/INGO/2102,18625,44567,16180,16180,95552,33486,75081,6225,6919,121711
53,Ethiopia,2,2015,ETH-15/DDA-3379/RB/N/INGO/2103,0,1947,380,395,2722,0,2628,1870,2014,6512
53,Ethiopia,2,2015,ETH-15/DDA-3379/RB/N/INGO/2104,4274,16024,5981,5879,32158,4517,21440,8357,8441,42755
53,Ethiopia,2,2015,ETH-15/DDA-3379/RB/WASH/INGO/2107,8182,12371,15115,15783,51451,10200,12170,10003,10447,42820
53,Ethiopia,2,2015,ETH-15/DDA-3379/RB/WASH/INGO/2108,13688,55809,22438,22438,114373,10008,36283,9863,11276,67430
53,Ethiopia,2,2015,ETH-15/DDA-3379/RB/N/INGO/2123,0,6173,4153,4322,14648,0,8493,4134,4870,17497
53,Ethiopia,2,2015,ETH-15/DDA-3379/RB/A/INGO/2136,12884,21114,27610,27040,88648,43124,59695,11389,12907,127115
53,Ethiopia,2,2015,ETH-15/DDA-3379/RB/WASH/INGO/2146,9950,10990,8635,9935,39510,17114,18885,14603,15797,66399
53,Ethiopia,2,2015,ETH-15/DDA-3379/RB/N/INGO/2152,69,8121,5830,5602,19622,0,15342,10187,11016,36545
53,Ethiopia,2,2016,ETH-16/DDA-3379/CP/H/UN/2154,1000000,2200000,1000000,1000000,5200000,1000000,2250000,1000000,1000000,5250000
53,Ethiopia,2,2015,ETH-15/DDA-3379/RB/WASH/INGO/2212,5150,7063,8146,8654,29013,14584,17359,17303,18752,67998
53,Ethiopia,2,2015,ETH-15/DDA-3379/CP/WASH/INGO/2217,10294,9890,2108,2026,24318,9900,9850,2001,2567,24318
53,Ethiopia,2,2015,ETH-15/DDA-3379/RB/N/INGO/2227,0,5543,2521,1981,10045,0,26080,11875,9323,47278
53,Ethiopia,2,2015,ETH-15/DDA-3379/CP/WASH/INGO/2237,29127,23259,0,0,52386,34993,37909,0,0,72902
53,Ethiopia,2,2015,ETH-15/DDA-3379/CP/WASH/INGO/2242,19562,18795,0,0,38357,7711,8164,14514,14968,45357
53,Ethiopia,2,2015,ETH-15/DDA-3379/CP/WASH/INGO/2257,10108,20190,5700,5700,41698,13964,27633,3285,3571,48453
53,Ethiopia,2,2015,ETH-15/DDA-3379/CP/WASH/INGO/2258,10374,7826,8750,8050,35000,27220,22586,4344,3764,57914
53,Ethiopia,2,2015,ETH-15/DDA-3379/CP/WASH/INGO/2263,1842,3418,2764,2876,10900,1701,3573,2580,2610,10464
53,Ethiopia,2,2015,ETH-15/DDA-3379/CP/WASH/INGO/2266,12024,13666,18037,18772,62499,16917,19581,23882,25004,85384
53,Ethiopia,2,2015,ETH-15/DDA-3379/CP/WASH/INGO/2267,6006,4634,7433,7027,25100,6184,11957,7637,7968,33746
53,Ethiopia,2,2015,ETH-15/DDA-3379/CP/WASH/INGO/2268,31224,32499,0,0,63723,52908,44478,11045,16569,125000
53,Ethiopia,2,2015,ETH-15/DDA-3379/RB/WASH/INGO/2269,2792,4537,6426,6314,20069,2774,4958,7482,6667,21881
53,Ethiopia,2,2015,ETH-15/DDA-3379/RB/WASH/INGO/2282,4764,4958,5372,5591,20685,18833,19638,21663,22368,82502
53,Ethiopia,2,2015,ETH-15/DDA-3379/RB/WASH/INGO/2289,17330,18038,0,0,35368,10389,9979,0,0,20368
53,Ethiopia,2,2015,ETH-15/DDA-3379/CP/WASH/INGO/2291,6720,6623,9680,9541,32564,7700,8230,9178,9337,34445
53,Ethiopia,2,2015,ETH-15/DDA-3379/CP/WASH/INGO/2292,36714,36329,0,0,73043,36714,36329,0,0,73043
53,Ethiopia,2,2015,ETH-15/DDA-3379/CP/WASH/INGO/2293,3161,3218,4324,3772,14475,4905,5345,5105,4755,20110
53,Ethiopia,2,2015,ETH-15/DDA-3379/RB/WASH/NGO/2294,17152,18213,0,0,35365,18507,19578,0,0,38085
53,Ethiopia,2,2015,ETH-15/DDA-3379/RB/P/UN/2296,150,110,15370,11130,26760,58,12,628,829,1527
53,Ethiopia,2,2015,ETH-15/DDA-3379/CP/WASH/INGO/2297,37449,31978,42080,41492,152999,38367,32762,43111,42509,156749
53,Ethiopia,2,2015,ETH-15/DDA-3379/CP/WASH/INGO/2303,5909,6151,0,0,12060,5929,6249,0,0,12178
53,Ethiopia,2,2015,ETH-15/DDA-3379/CP/WASH/INGO/2308,12311,10293,12000,10000,44604,12311,10293,12000,10000,44604
53,Ethiopia,2,2015,ETH-15/DDA-3379/CP/WASH/INGO/2309,5000,13100,4000,10900,33000,4700,11600,3500,10400,30200
53,Ethiopia,2,2015,ETH-15/DDA-3379/CP/WASH/INGO/2310,5880,6120,8820,9180,30000,5435,5657,8153,8487,27732
53,Ethiopia,2,2015,ETH-15/DDA-3379/RB/A/INGO/2315,126535,131700,0,0,258235,130332,130063,0,0,260395
53,Ethiopia,2,2016,ETH-16/DDA-3379/CP/N/INGO/2322,0,1663,1523,1586,4772,0,2078,802,1082,3962
53,Ethiopia,2,2016,ETH-16/DDA-3379/RB/WASH/INGO/2323,10560,14400,11040,12000,48000,10560,14400,11040,12000,48000
53,Ethiopia,2,2016,ETH-16/DDA-3379/CP/NUTRITION/INGO/2324,4031,6753,7369,7719,25872,3140,4090,10020,10430,27680
53,Ethiopia,2,2016,ETH-16/DDA-3379/RB/WASH/INGO/2326,6227,6593,11720,12086,36626,12518,13028,0,0,25546
53,Ethiopia,2,2016,ETH-16/DDA-3379/CP/WASH/INGO/2332,5621,7186,7695,8030,28532,5415,7332,7573,8558,28878
53,Ethiopia,2,2016,ETH-16/DDA-3379/CP/N/UN/2345,0,212781,60522,60200,333503,0,182465,123459,128457,434381
53,Ethiopia,2,2016,ETH-16/DDA-3379/CP/NFI/ES/UN/2349,7893,7474,11432,9501,36300,8373,7993,11798,9896,38060
53,Ethiopia,2,2016,ETH-16/DDA-3379/CP/N/UN/2358,4900000,5300000,0,0,10200000,0,0,0,0,0
53,Ethiopia,2,2016,ETH-16/DDA-3379/CP/H/UN/2392,12965,16075,19520,17884,66444,16568,15814,23345,19580,75307
53,Ethiopia,2,2016,ETH-16/DDA-3379/CP/NFI/ES/INGO/2400,6113,6507,11762,11368,35750,6578,7222,12770,12840,39410
53,Ethiopia,2,2016,ETH-16/DDA-3379/CP/H/INGO/2415,24353,24549,7337,7278,63517,23351,21210,6650,6621,57832
53,Ethiopia,2,2016,ETH-16/DDA-3379/CP/N/INGO/2417,0,2295,722,591,3608,0,4831,2809,2992,10632
53,Ethiopia,2,2016,ETH-16/DDA-3379/CP/NFI/ES/INGO/2418,21,22,30,27,100,17,20,30,33,100
53,Ethiopia,2,2016,ETH-16/DDA-3379/CP/N-H/INGO/2423,7788,55044,15121,15122,93075,8629,86210,15017,7224,117080
53,Ethiopia,2,2016,ETH-16/DDA-3379/CP/N-H-FSL-WASH/INGO/2424,12428,84810,66317,69447,233002,38124,97236,47254,50869,233483
53,Ethiopia,2,2016,ETH-16/DDA-3379/CP/A-N-WASH/INGO/2428,22366,25092,19310,19985,86753,28942,32377,17587,17219,96125
53,Ethiopia,2,2016,ETH-16/DDA-3379/CP/WASH/INGO/2440,3187,3774,688,541,8190,23040,25920,4608,4032,57600
53,Ethiopia,2,2016,ETH-16/DDA-3379/CP/H/INGO/2445,7800,19500,5850,5850,39000,11300,11406,8460,7834,39000
53,Ethiopia,2,2016,ETH-16/DDA-3379/CP/N-WASH-H/INGO/2450,0,1311,2482,2582,6375,0,10687,3674,3826,18187
53,Ethiopia,2,2016,ETH-16/DDA-3379/CP/H/INGO/2452,11256,12507,18712,20057,62532,11709,42414,5153,4970,64246
53,Ethiopia,2,2016,ETH-16/DDA-3379/CP/N-WASH-NFI/ES-FSL/INGO/2459,15408,9913,2461,1772,29554,14174,9202,1820,1358,26554
53,Ethiopia,2,2016,ETH-16/DDA-3379/CP/A/INGO/2490,84893,88357,0,0,173250,84893,88357,0,0,173250
53,Ethiopia,2,2016,ETH-16/DDA-3379/CP/A/INGO/2508,13711,14484,11042,12026,51263,21081,22269,16977,18490,78817
53,Ethiopia,2,2016,ETH-16/DDA-3379/CP/A/INGO/2517,53513,55240,29346,34425,172524,64087,66156,35145,41227,206615
53,Ethiopia,2,2016,ETH-16/DDA-3379/CP/A/INGO/2519,9872,10482,16770,16439,53563,13325,12549,21741,20474,68089
53,Ethiopia,2,2016,ETH-16/DDA-3379/CP/A-WASH/INGO/2520,24301,24302,6075,6075,60753,28543,19213,6575,8199,62530
53,Ethiopia,2,2016,ETH-16/DDA-3379/CP/A/INGO/2522,9811,9921,10000,9328,39060,16979,17171,17306,16144,67600
53,Ethiopia,2,2016,ETH-16/DDA-3379/CP/A/UN/2526,19180,27400,41648,48772,137000,28910,37741,61026,61028,188705
53,Ethiopia,2,2016,ETH-16/DDA-3379/CP/N/INGO/2554,765,14069,7396,7991,30221,1207,13461,7242,8752,30662
53,Ethiopia,2,2016,ETH-16/DDA-3379/CP/N-WASH/INGO/2577,66,6589,8871,8523,24049,0,19660,12963,13547,46170
53,Ethiopia,2,2016,ETH-16/DDA-3379/RB/WASH/UN/2734,115248,119952,119952,124848,480000,26337,27412,27412,28530,109691
53,Ethiopia,2,2016,ETH-16/DDA-3379/CP/N-H/INGO/2742,16638,48456,14757,14764,94615,14850,84812,13880,23575,137117
53,Ethiopia,2,2016,ETH-16/DDA-3379/RB/N/INGO/2804,0,3920,2160,2200,8280,0,4821,3076,3030,10927
53,Ethiopia,2,2016,ETH-16/DDA-3379/CP/FSL-N-H-WASH/INGO/2863,20405,15765,8360,8111,52641,14569,44827,28875,29566,117837
53,Ethiopia,2,2016,ETH-16/DDA-3379/RB/A/INGO/2963,265007,284995,61544,67950,679496,293024,315125,68050,75134,751333
53,Ethiopia,2,2016,ETH-16/DDA-3379/RB/N/INGO/2992,8534,39389,34645,33284,115852,15336,52400,26953,27615,122304
53,Ethiopia,2,2016,ETH-16/DDA-3379/RB/A/UN/3133,26250,37500,57000,66750,187500,47538,63789,103806,103810,318943
53,Ethiopia,2,2016,ETH-16/DDA-3379/RB/H/UN/3141,14689,17363,5409,6139,43600,16241,19198,5981,6788,48208
53,Ethiopia,2,2016,ETH-16/DDA-3379/RB/P/UN/3142,21555,42665,14371,28443,107034,11193,26700,8087,19488,65468
53,Ethiopia,2,2016,ETH-16/DDA-3379/RB/NFI/ES/INGO/3143,10489,10636,14911,13668,49704,9314,10395,14574,13359,47642
53,Ethiopia,2,2016,ETH-16/DDA-3379/RB/P/INGO/3145,3000,7000,3000,5000,18000,1889,9029,559,3878,15355
53,Ethiopia,2,2016,ETH-16/DDA-3379/RB/CSS/UN/3152,2282123,2406125,0,0,4688248,4164172,4081711,0,0,8245883
53,Ethiopia,2,2016,ETH-16/DDA-3379/RB/N/INGO/3175,0,3311,1910,1989,7210,0,4035,1452,1573,7060
53,Ethiopia,2,2016,ETH-16/DDA-3379/CP/H-WASH/INGO/3387,123824,146651,30129,30650,331254,143089,169468,34817,35180,382554
53,Ethiopia,2,2016,ETH-16/DDA-3379/CP/WASH-H/INGO/3446,28778,29953,5079,5286,69096,72967,75945,12877,13402,175191
53,Ethiopia,2,2016,ETH-16/DDA-3379/CP/WASH/INGO/3451,170412,161319,0,0,331731,0,0,0,0,0
53,Ethiopia,2,2016,ETH-16/DDA-3379/RB/L/UN/3480,43418,124570,93040,100792,361820,43418,124570,93040,100792,361820
53,Ethiopia,2,2016,ETH-16/DDA-3379/CP/WASH-H/INGO/3483,32000,32000,8000,8000,80000,51940,54060,12985,13515,132500
53,Ethiopia,2,2016,ETH-16/DDA-3379/CP/WASH/INGO/3506,9591,9454,13814,13616,46475,14522,13489,14711,14542,57264
53,Ethiopia,2,2016,ETH-16/DDA-3379/CP/WASH/INGO/3512,12027,11556,2123,2039,27745,13973,13648,2599,2275,32495
53,Ethiopia,2,2016,ETH-16/DDA-3379/CP/WASH-H/INGO/3543,66667,49990,33339,16670,166666,72019,82906,18005,14630,187560
53,Ethiopia,2,2016,ETH-16/DDA-3379/CP/WASH/INGO/3557,174345,179256,238189,226730,818520,143787,151036,169840,306299,770962
53,Ethiopia,2,2016,ETH-16/DDA-3379/RB/L/INGO/3755,0,443686,221843,221843,887372,0,406671,203336,203336,813343
53,Ethiopia,2,2016,ETH-16/DDA-3379/CP/H/UN/3767,850,850,150,150,2000,769,800,513,533,2615
53,Ethiopia,2,2016,ETH-16/DDA-3379/RB/H-WASH-NFI/ES/INGO/4427,10000,10000,20000,20000,60000,48607,50589,30778,24274,154248
53,Ethiopia,2,2016,ETH-16/DDA-3379/RB/L/UN/4431,65823,186498,142616,153586,548523,65828,187255,142620,152897,548600
53,Ethiopia,2,2017,ETH-17/DDA-3379/CP/H/UN/4448,38000,41000,42000,44000,165000,35485,38287,39220,41088,154080
53,Ethiopia,2,2017,ETH-17/DDA-3379/CP/WASH/UN/4451,215103,223887,216396,237340,892726,225769,234988,227126,249108,936991
53,Ethiopia,2,2017,ETH-17/DDA-3379/CP/A/UN/4452,52500,52500,0,0,105000,26836,31315,72700,72697,203548
53,Ethiopia,2,2017,ETH-17/DDA-3379/CP/A/INGO/4465,3350,3350,7236,4489,18425,3350,3350,7236,4489,18425
53,Ethiopia,2,2017,ETH-17/DDA-3379/CP/A/INGO/4467,604,906,3020,4530,9060,873,1201,4365,6005,12444
53,Ethiopia,2,2017,ETH-17/DDA-3379/CP/P/INGO/4476,2500,2500,1000,4000,10000,7600,3210,2120,4538,17468
53,Ethiopia,2,2017,ETH-17/DDA-3379/CP/A/INGO/4481,3320,3456,4981,5184,16941,5350,5568,8025,8352,27295
53,Ethiopia,2,2017,ETH-17/DDA-3379/CP/A-H-WASH/INGO/4485,13697,13157,0,0,26854,11998,13640,2567,2980,31185
53,Ethiopia,2,2017,ETH-17/DDA-3379/CP/A/INGO/4501,19900,19900,39800,39800,119400,19900,19900,39800,39800,119400
53,Ethiopia,2,2017,ETH-17/DDA-3379/CP/WASH/INGO/4504,8466,18637,27345,25714,80162,9981,19487,27320,25868,82656
53,Ethiopia,2,2017,ETH-17/DDA-3379/CP/WASH/INGO/4505,6948,6215,10939,9308,33410,8183,7091,12335,10474,38083
53,Ethiopia,2,2017,ETH-17/DDA-3379/CP/A/INGO/4506,524,786,2620,3930,7860,786,1179,2948,4912,9825
53,Ethiopia,2,2017,ETH-17/DDA-3379/CP/WASH/INGO/4507,76228,114340,0,0,190568,76874,115312,0,0,192186
53,Ethiopia,2,2017,ETH-17/DDA-3379/CP/A/NGO/4508,4040,2649,16160,8260,31109,4216,2134,15912,7225,29487
53,Ethiopia,2,2017,ETH-17/DDA-3379/CP/H/UN/4511,55328,57586,44027,44027,200968,57971,60501,46166,46167,210805
53,Ethiopia,2,2017,ETH-17/DDA-3379/CP/H/INGO/4512,9756,14634,0,0,24390,9756,14634,0,0,24390
53,Ethiopia,2,2017,ETH-17/DDA-3379/CP/A/INGO/4513,17787,7623,0,0,25410,5478,10362,4804,3836,24480
53,Ethiopia,2,2017,ETH-17/DDA-3379/CP/WASH/INGO/4514,24168,25274,4265,4460,58167,21368,22471,3480,3488,50807
53,Ethiopia,2,2017,ETH-17/DDA-3379/CP/N/INGO/4515,0,1867,3627,3049,8543,0,4981,2382,2732,10095
53,Ethiopia,2,2017,ETH-17/DDA-3379/CP/N/INGO/4516,0,13686,5431,5884,25001,0,6622,2180,2361,11163
53,Ethiopia,2,2017,ETH-17/DDA-3379/CP/N/INGO/4778,27132,32203,7537,7241,74113,17604,61740,20562,21303,121209
53,Ethiopia,2,2017,ETH-17/DDA-3379/CP/N/INGO/4787,0,936,5296,4840,11072,109,12457,5791,6507,24864
53,Ethiopia,2,2017,ETH-17/DDA-3379/CP/N/INGO/4791,0,3419,2195,2108,7722,0,6158,1845,1794,9797
53,Ethiopia,2,2017,ETH-17/DDA-3379/CP/A/INGO/4826,6457,6203,0,0,12660,7065,6789,0,0,13854
53,Ethiopia,2,2017,ETH-17/DDA-3379/CP/N/INGO/4896,205,1704,2377,2377,6663,382,4381,2987,3058,10808
53,Ethiopia,2,2017,ETH-17/DDA-3379/CP/N/INGO/4948,0,21905,43315,42117,107337,0,26141,46706,48810,121657
53,Ethiopia,2,2017,ETH-17/DDA-3379/CP/P/INGO/5068,3578,5058,3660,2525,14821,477,503,371,283,1634
53,Ethiopia,2,2017,ETH-17/DDA-3379/CP/WASH/INGO/5303,20100,32161,23115,25126,100502,19675,32200,22627,24593,99095
53,Ethiopia,2,2017,ETH-17/DDA-3379/CP/N/UN/5306,0,0,6650,6650,13300,0,0,7056,7055,14111
53,Ethiopia,2,2017,ETH-17/DDA-3379/CP/N/INGO/5307,0,1754,3952,3106,8812,0,3879,5480,4395,13754
53,Ethiopia,2,2017,ETH-17/DDA-3379/CP/N/INGO/5310,335,6803,1155,1202,9495,0,1890,971,1185,4046
53,Ethiopia,2,2017,ETH-17/DDA-3379/CP/H/INGO/5312,9246,9624,0,0,18870,0,0,0,0,0
53,Ethiopia,2,2017,ETH-17/DDA-3379/CP/N/INGO/5326,0,6044,4844,4892,15780,0,3576,2653,2772,9001
53,Ethiopia,2,2017,ETH-17/DDA-3379/CP/P/INGO/5336,9695,9748,22093,21627,63163,14440,18028,18970,16941,68379
53,Ethiopia,2,2017,ETH-17/DDA-3379/CP/A/NGO/5337,9288,2310,0,0,11598,9288,2310,0,0,11598
53,Ethiopia,2,2017,ETH-17/DDA-3379/CP/H/INGO/5344,22944,25056,0,0,48000,19503,22551,3441,2505,48000
53,Ethiopia,2,2017,ETH-17/DDA-3379/CP/NFI/ES/INGO/5348,7023,6703,9896,8300,31922,0,0,0,0,0
53,Ethiopia,2,2017,ETH-17/DDA-3379/CP/P/INGO/5358,7520,7923,5684,5134,26261,1481,8735,1109,1339,12664
53,Ethiopia,2,2017,ETH-17/DDA-3379/CP/WASH/INGO/5380,20452,26100,31210,33362,111124,21643,24775,31846,34045,112309
53,Ethiopia,2,2017,ETH-17/DDA-3379/CP/N/INGO/5386,0,4273,3513,3774,11560,0,15137,10633,10936,36706
53,Ethiopia,2,2017,ETH-17/DDA-3379/CP/N/INGO/5392,169,1556,1473,1415,4613,23,7640,3777,3931,15371
53,Ethiopia,2,2017,ETH-17/DDA-3379/CP/A/INGO/5414,32460,19476,6492,6492,64920,44370,22086,5760,3967,76183
53,Ethiopia,2,2017,ETH-17/DDA-3379/CP/A/INGO/5421,3192,2408,0,0,5600,3010,4270,2195,1725,11200
53,Ethiopia,2,2017,ETH-17/DDA-3379/CP/WASH/UN/5442,61466,63974,64000,66560,256000,0,0,0,0,0
53,Ethiopia,2,2017,ETH-17/DDA-3379/CP/N/INGO/5451,0,2494,2443,2542,7479,0,3618,1636,2010,7264
53,Ethiopia,2,2017,ETH-17/DDA-3379/CP/A/INGO/5455,1114,1098,1605,1583,5400,1114,1098,1605,1583,5400
53,Ethiopia,2,2017,ETH-17/DDA-3379/CP/A/INGO/5457,2601,2499,0,0,5100,3160,3240,0,0,6400
53,Ethiopia,2,2017,ETH-17/DDA-3379/CP/A/INGO/5459,604,906,3020,4530,9060,546,964,2730,4820,9060
53,Ethiopia,2,2017,ETH-17/DDA-3379/CP/N/INGO/5460,0,1580,894,932,3406,0,1742,977,1016,3735
53,Ethiopia,2,2017,ETH-17/DDA-3379/CP/A/INGO/5465,1250,1250,2700,1675,6875,1250,1250,2700,1675,6875
53,Ethiopia,2,2017,ETH-17/DDA-3379/CP/NFI/ES/UN/5479,154000,147000,217000,182000,700000,655260,674437,413527,414954,2158178
53,Ethiopia,2,2017,ETH-17/DDA-3379/CP/N/INGO/5480,0,9527,17862,17862,45251,0,16388,17662,17808,51858
53,Ethiopia,2,2017,ETH-17/DDA-3379/CP/NFI/ES/UN/5481,6325,6038,8913,7476,28752,6515,6220,9181,7701,29617
53,Ethiopia,2,2017,ETH-17/DDA-3379/CP/H/UN/5784,1271678,1125079,1925914,1426326,5748997,1271678,1125079,1925914,1426326,5748997
53,Ethiopia,2,2017,ETH-17/DDA-3379/CP/N/UN/5790,26500,26500,26500,26500,106000,8828,34488,43658,43659,130633
53,Ethiopia,2,2017,ETH-17/DDA-3379/CP/WASH/INGO/5814,40519,42691,30627,27663,141500,40291,71355,18476,28257,158379
53,Ethiopia,2,2017,ETH-17/DDA-3379/CP/WASH-H/INGO/6033,4360,4190,5330,5120,19000,4155,4682,5411,4892,19140
53,Ethiopia,2,2017,ETH-17/DDA-3379/ETH-17/DDA-3379/WASH/UN/6674,1071749,1115515,1078191,1182545,4448000,0,0,0,0,0
53,Ethiopia,2,2017,ETH-17/DDA-3379/ETH-17/DDA-3379/WASH/INGO/6684,50571,52880,12643,13220,129314,38040,46488,9512,11624,105664
53,Ethiopia,2,2017,ETH-17/DDA-3379/ETH-17/DDA-3379/N/INGO/6685,222,714,649,675,2260,431,684,615,673,2403
53,Ethiopia,2,2017,ETH-17/DDA-3379/ETH-17/DDA-3379/WASH/INGO/6686,73500,76500,0,0,150000,37087,37955,0,0,75042
53,Ethiopia,2,2017,ETH-17/DDA-3379/ETH-17/DDA-3379/H/UN/6712,42336,44064,45864,47736,180000,31786,33083,34434,35840,135143
53,Ethiopia,2,2017,ETH-17/DDA-3379/ETH-17/DDA-3379/WASH/INGO/6716,13975,18536,8510,7968,48989,2701,12248,1268,1276,17493
53,Ethiopia,2,2017,ETH-17/DDA-3379/ETH-17/DDA-3379/A/INGO/6722,5496,5720,2959,3080,17255,8899,9277,4779,5060,28015
53,Ethiopia,2,2017,ETH-17/DDA-3379/ETH-17/DDA-3379/A/INGO/6723,38367,16443,16443,7047,78300,71034,22626,6501,363,100524
53,Ethiopia,2,2017,ETH-17/DDA-3379/ETH-17/DDA-3379/H/INGO/6724,2366,45204,17745,18469,83784,6372,14049,17543,17413,55377
53,Ethiopia,2,2017,ETH-17/DDA-3379/ETH-17/DDA-3379/NFI/ES/INGO/6725,4754,5169,7260,7040,24223,14245,13077,1903,1755,30980
53,Ethiopia,2,2017,ETH-17/DDA-3379/ETH-17/DDA-3379/E/INGO/6726,180,76,4074,3333,7663,78,48,3968,2699,6793
53,Ethiopia,2,2017,ETH-17/DDA-3379/ETH-17/DDA-3379/N/INGO/6730,9580,11502,3047,2928,27057,6530,12992,880,902,21304
53,Ethiopia,2,2017,ETH-17/DDA-3379/ETH-17/DDA-3379/WASH/INGO/6735,10710,10290,3570,3430,28000,6384,6041,1916,1787,16128
53,Ethiopia,2,2017,ETH-17/DDA-3379/ETH-17/DDA-3379/N/INGO/6737,100,3789,1304,1360,6553,85,4881,1317,1546,7829
53,Ethiopia,2,2017,ETH-17/DDA-3379/ETH-17/DDA-3379/H/UN/6738,42336,44064,45864,47736,180000,42323,44057,45987,47098,179465
53,Ethiopia,2,2017,ETH-17/DDA-3379/ETH-17/DDA-3379/A/INGO/6741,3556,3416,0,0,6972,4766,4373,0,0,9139
53,Ethiopia,2,2017,ETH-17/DDA-3379/ETH-17/DDA-3379/A/INGO/6743,2376,2376,5148,3300,13200,2376,2376,5148,3300,13200
53,Ethiopia,2,2017,ETH-17/DDA-3379/ETH-17/DDA-3379/A/UN/6744,44736,44736,44745,44745,178962,6070,10468,23182,23065,62785
53,Ethiopia,2,2017,ETH-17/DDA-3379/ETH-17/DDA-3379/A/INGO/6754,1053,1037,1516,1494,5100,1102,1086,1588,1564,5340
53,Ethiopia,2,2017,ETH-17/DDA-3379/ETH-17/DDA-3379/P/UN/6757,2189,2519,3245,3047,11000,6891,7924,9992,9647,34454
53,Ethiopia,2,2017,ETH-17/DDA-3379/ETH-17/DDA-3379/WASH/INGO/6759,5890,6510,8990,9610,31000,9097,10290,11244,12307,42938
53,Ethiopia,2,2017,ETH-17/DDA-3379/ETH-17/DDA-3379/WASH/INGO/6760,10143,6486,13984,12555,43168,10143,6486,13984,12555,43168
53,Ethiopia,2,2017,ETH-17/DDA-3379/ETH-17/DDA-3379/NFI/ES/UN/6765,5060,5358,9823,9525,29766,6205,7300,11680,11314,36499
53,Ethiopia,2,2017,ETH-17/DDA-3379/ETH-17/DDA-3379/N/INGO/6768,0,3204,2309,2214,7727,0,5638,2711,3211,11560
53,Ethiopia,2,2017,ETH-17/DDA-3379/ETH-17/DDA-3379/NFI/ES/INGO/6769,6170,9028,8695,10429,34322,6170,9028,8695,10429,34322
53,Ethiopia,2,2017,ETH-17/DDA-3379/ETH-17/DDA-3379/A/INGO/6770,900,900,1800,1800,5400,700,1100,2200,1400,5400
53,Ethiopia,2,2017,ETH-17/DDA-3379/ETH-17/DDA-3379/WASH-H/INGO/6773,35233,36672,6218,6471,84594,6078,7317,4400,4732,22527
53,Ethiopia,2,2017,ETH-17/DDA-3379/ETH-17/DDA-3379/H/INGO/6775,28387,27273,23224,22314,101198,4550,6381,4904,5786,21621
53,Ethiopia,2,2017,ETH-17/DDA-3379/ETH-17/DDA-3379/N/UN/6779,0,0,93250,93250,186500,0,0,35932,35933,71865
53,Ethiopia,2,2017,ETH-17/DDA-3379/ETH-17/DDA-3379/N/INGO/6781,0,4551,3583,3728,11862,1046,3538,3108,3156,10848
53,Ethiopia,2,2017,ETH-17/DDA-3379/ETH-17/DDA-3379/WASH/INGO/6785,20952,24477,11976,14305,71710,25502,26324,13984,16453,82263
53,Ethiopia,2,2017,ETH-17/DDA-3379/ETH-17/DDA-3379/N/NGO/6791,0,1832,8718,9074,19624,0,2635,6615,6842,16092
53,Ethiopia,2,2017,ETH-17/DDA-3379/ETH-17/DDA-3379/H/NGO/6793,63485,66075,13936,14504,158000,17660,18613,16741,30667,83681
53,Ethiopia,2,2017,ETH-17/DDA-3379/ETH-17/DDA-3379/N/INGO/6798,0,14431,27747,28534,70712,0,14614,32598,33928,81140
53,Ethiopia,2,2017,ETH-17/DDA-3379/ETH-17/DDA-3379/A/INGO/6799,2964,2964,0,0,5928,3432,2722,0,0,6154
53,Ethiopia,2,2017,ETH-17/DDA-3379/ETH-17/DDA-3379/N/INGO/6800,0,1024,1991,2112,5127,0,9609,5663,5976,21248
53,Ethiopia,2,2017,ETH-17/DDA-3379/ETH-17/DDA-3379/N/INGO/6803,0,1426,1153,1200,3779,0,2638,1529,1445,5612
53,Ethiopia,2,2017,ETH-17/DDA-3379/ETH-17/DDA-3379/WASH/INGO/6819,744,1506,1938,1812,6000,615,1245,1602,1499,4961
53,Ethiopia,2,2017,ETH-17/DDA-3379/ETH-17/DDA-3379/CSS/UN/6822,600,400,0,0,1000,0,0,0,0,0
53,Ethiopia,2,2017,ETH-17/DDA-3379/ETH-17/DDA-3379/N/NGO/6838,0,14767,4671,4725,24163,0,13780,4302,4482,22564
53,Ethiopia,2,2017,ETH-17/DDA-3379/ETH-17/DDA-3379/P/INGO/6916,535,490,0,0,1025,469,850,0,0,1319
53,Ethiopia,2,2017,ETH-17/DDA-3379/ETH-17/DDA-3379/P/INGO/6917,1430,3880,1540,3650,10500,1139,1063,3362,5645,11209
53,Ethiopia,1,2017,ETH-17/DDA-3379/CP/N/INGO/7328,246,2322,3382,3382,9332,301,10616,8756,9610,29283
53,Ethiopia,1,2017,ETH-17/DDA-3379/CP/N/INGO/7612,0,0,1442,1696,3138,1179,5584,1873,2221,10857
53,Ethiopia,1,2017,ETH-17/DDA-3379/CP/N/INGO/7628,0,6953,5516,5741,18210,0,4443,2332,2425,9200
53,Ethiopia,1,2017,ETH-17/DDA-3379/CP/N/NGO/7632,0,2017,5944,6185,14146,0,5091,6760,7058,18909
53,Ethiopia,1,2017,ETH-17/DDA-3379/CP/WASH-NFI/ES/INGO/7660,29022,43408,7254,10852,90536,8812,10645,2280,2754,24491
53,Ethiopia,1,2017,ETH-17/DDA-3379/CP/N/UN/7664,0,3500,8000,8000,19500,0,3500,7865,7866,19231
53,Ethiopia,2,2018,ETH-18/DDA-3379/SA1/N-H/INGO/8964,1454,7283,6411,7531,22679,147,722,191,233,1293
53,Ethiopia,2,2018,ETH-18/DDA-3379/SA1/A/INGO/8985,110201,108264,200311,197821,616597,97365,97910,90483,87229,372987
53,Ethiopia,2,2018,ETH-18/DDA-3379/SA1/N/NGO/8991,0,1065,3809,3965,8839,0,2423,1216,1264,4903
53,Ethiopia,2,2018,ETH-18/DDA-3379/SA1/N/NGO/8992,0,1758,4963,5164,11885,0,3509,1522,1602,6633
53,Ethiopia,2,2018,ETH-18/DDA-3379/SA1/N-H/INGO/8993,2339,16304,9098,9098,36839,1799,4099,469,493,6860
53,Ethiopia,2,2018,ETH-18/DDA-3379/SA1/H/UN/9041,17640,18360,19110,19890,75000,15700,16720,18235,19723,70378
53,Ethiopia,2,2018,ETH-18/DDA-3379/SA1/N/INGO/9043,0,5233,4803,5204,15240,0,1651,1477,1526,4654
53,Ethiopia,2,2018,ETH-18/DDA-3379/SA1/H/NGO/9049,16024,16281,3086,3134,38525,4866,6456,3316,2987,17625
53,Ethiopia,2,2018,ETH-18/DDA-3379/SA1/N/INGO/9063,62,13353,9600,9993,33008,1891,15775,5533,5789,28988
53,Ethiopia,2,2018,ETH-18/DDA-3379/SA1/WASH/INGO/9090,25504,24503,6251,6251,62509,14785,16017,1285,1393,33480
53,Ethiopia,2,2018,ETH-18/DDA-3379/SA1/WASH/INGO/9100,2091,2301,0,0,4392,0,0,0,0,0
53,Ethiopia,2,2018,ETH-18/DDA-3379/SA2/H/NGO/9633,12459,12263,2399,2361,29482,6297,10269,5370,5664,27600
53,Ethiopia,2,2018,ETH-18/DDA-3379/SA2/N/NGO/9645,0,4988,9967,10374,25329,0,7926,3011,3211,14148
53,Ethiopia,2,2018,ETH-18/DDA-3379/SA2/WASH/INGO/9651,10299,10276,8325,8289,37189,0,0,0,0,0
53,Ethiopia,2,2018,ETH-18/DDA-3379/SA2/H/NGO/9659,19504,19200,3754,3694,46152,2696,4012,1319,1207,9234
53,Ethiopia,2,2018,ETH-18/DDA-3379/SA2/N/NGO/9663,0,4500,5449,5457,15406,0,5749,2357,2629,10735
53,Ethiopia,2,2018,ETH-18/DDA-3379/SA2/N/INGO/9672,0,4637,3527,3671,11835,0,4178,4299,4354,12831
72,Iraq,2,2015,IRQ-15/3884/SA/H/NGO/1745,11000,14000,2000,3000,30000,11372,8980,3117,2981,26450
72,Iraq,2,2015,IRQ-15/3884/SA/H/INGO/1746,14025,13475,11025,11475,50000,5399,7879,5544,5028,23850
72,Iraq,2,2015,IRQ-15/3884/SA/F/NGO/1756,1969,2480,1607,2244,8300,2550,2497,1665,2335,9047
72,Iraq,2,2015,IRQ-15/3884/SA/P/NGO/1758,1970,1855,0,0,3825,1980,1897,0,0,3877
72,Iraq,2,2015,IRQ-15/3884/SA/CCCM/INGO/1759,0,0,0,0,0,6623,6925,8280,8281,30109
72,Iraq,2,2015,IRQ-15/3884/SA/P/INGO/1760,200,50,50,100,400,181,708,65,74,1028
72,Iraq,2,2015,IRQ-15/3884/SA/F/NGO/1761,5000,6000,2500,3000,16500,5661,6794,2830,3400,18685
72,Iraq,2,2015,IRQ-15/3884/SA/WASH/INGO/1770,5520,5520,6000,6960,24000,8210,8210,10450,10450,37320
72,Iraq,2,2015,IRQ-15/3884/SA/ELSC/NGO/1778,497,561,360,406,1824,329,390,568,576,1863
72,Iraq,2,2015,IRQ-15/3884/SA/NFIs/NGO/1779,943,1230,779,1148,4100,1478,1647,1154,1031,5310
72,Iraq,2,2015,IRQ-15/3884/SA/WASH/NGO/1780,24843,25685,22551,24921,98000,13556,13003,10865,10466,47890
72,Iraq,2,2015,IRQ-15/3884/SA/E/INGO/1785,284,426,1664,2496,4870,611,361,1910,1995,4877
72,Iraq,2,2015,IRQ-15/3884/SA/ELSC/INGO/1786,240,1040,550,1000,2830,484,823,1670,4163,7140
72,Iraq,2,2015,IRQ-15/3884/SA/WASH/INGO/1787,3737,3622,3983,3850,15192,8599,8119,6068,6063,28849
72,Iraq,2,2015,IRQ-15/3884/SA/ELSC/INGO/1788,526,593,380,429,1928,544,607,440,503,2094
72,Iraq,2,2015,IRQ-15/3884/SA/WASH/INGO/1791,2609,2609,3044,2610,10872,2752,2871,2985,2688,11296
72,Iraq,2,2015,IRQ-15/3884/SA/WASH/INGO/1793,84486,84486,56325,56325,281622,248957,260273,316854,305538,1131622
72,Iraq,2,2015,IRQ-15/3884/SA/WASH/INGO/1794,4410,4590,1500,1500,12000,3989,4266,1330,1422,11007
72,Iraq,2,2015,IRQ-15/3884/SA/H/INGO/1795,4043,4208,3307,3442,15000,580,775,666,557,2578
72,Iraq,2,2015,IRQ-15/3884/SA/H/UN/1803,152267,158483,124852,129668,565270,132216,126927,137505,132216,528864
72,Iraq,2,2015,IRQ-15/3884/SA/P/NGO/1807,0,45000,0,19700,64700,0,36264,0,27165,63429
72,Iraq,2,2015,IRQ-15/3884/SA/P/INGO/1808,100,100,400,400,1000,245,262,1917,1527,3951
72,Iraq,2,2015,IRQ-15/3884/SA/WASH/INGO/1814,6338,6552,6055,6055,25000,12072,13795,4483,4138,34488
72,Iraq,2,2015,IRQ-15/3884/SA/H/INGO/1815,14950,17550,16250,16250,65000,10669,10068,9932,8360,39029
72,Iraq,2,2015,IRQ-15/3884/SA/H/INGO/1816,4940,8320,6760,5980,26000,4072,6816,4701,4811,20400
72,Iraq,2,2015,IRQ-15/3884/SA/WASH/NGO/1817,261521,256573,521397,466509,1506000,2546,3265,2168,2782,10761
72,Iraq,2,2015,IRQ-15/3884/SA/NFIs/NGO/1818,200,380,820,600,2000,200,380,820,600,2000
72,Iraq,2,2015,IRQ-15/3884/SA/WASH/INGO/1819,11875,14250,10687,10688,47500,12064,14527,10833,10834,48258
72,Iraq,2,2015,IRQ-15/3884/SA/NFIs/INGO/1822,2888,3006,983,983,7860,1789,1947,2210,2134,8080
72,Iraq,2,2015,IRQ-15/3884/SA/NFIs/INGO/1823,1874,1951,637,638,5100,1546,1631,1604,1615,6396
72,Iraq,2,2015,IRQ-15/3884/SA/F/UN/1870,12348,12852,0,0,25200,12348,12852,0,0,25200
72,Iraq,2,2015,IRQ-15/3884/SA/H/UN/1871,21600,32400,9000,9000,72000,30855,33520,22874,27814,115063
72,Iraq,2,2015,IRQ-15/3884/SA/E/UN/1872,0,0,4905,4905,9810,160,127,6028,4891,11206
72,Iraq,2,2015,IRQ-15/3884/SA/NFIs/INGO/1965,1637,1577,882,882,4978,1418,1369,1327,1236,5350
72,Iraq,2,2015,IRQ-15/3884/SA/WASH/UN/1966,39015,37485,37485,36015,150000,52964,50887,50886,48891,203628
72,Iraq,2,2015,IRQ-15/3884/SA/H/UN/1970,0,0,2449878,2353807,4803685,0,0,1890106,1967254,3857360
72,Iraq,2,2015,IRQ-15/3884/SA/P/INGO/1972,400,600,1000,1500,3500,666,433,2875,2691,6665
72,Iraq,1,2016,IRQ-16/3884/RA/CASH/INGO/2401,176,244,0,0,420,333,75,0,0,408
72,Iraq,1,2016,IRQ-16/3884/RA/CASH/INGO/2402,747,801,561,561,2670,1284,1252,0,0,2536
72,Iraq,1,2016,IRQ-16/3884/RA/CASH/INGO/2430,200,840,510,850,2400,471,323,749,855,2398
72,Iraq,2,2016,IRQ-16/3884/ST/H/NGO/2540,9900,7800,6600,5700,30000,15478,12966,4200,4139,36783
72,Iraq,2,2016,IRQ-16/3884/ST/F/NGO/2541,1335,3360,1065,2240,8000,1486,3739,1186,2493,8904
72,Iraq,2,2016,IRQ-16/3884/ST/WASH/NGO/2542,3600,14400,7200,10800,36000,4973,19898,9950,14925,49746
72,Iraq,2,2016,IRQ-16/3884/ST/CCS/UN/2543,27000,6750,1100,350,35200,42883,10802,729,205,54619
72,Iraq,2,2016,IRQ-16/3884/ST/WASH/INGO/2556,31056,28308,10510,10971,80845,31182,28720,10667,11488,82057
72,Iraq,2,2016,IRQ-16/3884/ST/ELSC/INGO/2568,900,900,1800,1800,5400,1864,2132,693,639,5328
72,Iraq,2,2016,IRQ-16/3884/ST/H/INGO/2569,11500,13500,12500,12500,50000,13847,15640,13250,13298,56035
72,Iraq,2,2016,IRQ-16/3884/ST/F/NGO/2570,3969,4131,3381,3519,15000,3549,3485,4112,3891,15037
72,Iraq,2,2016,IRQ-16/3884/ST/WASH/NGO/2573,12392,11902,9936,9543,43773,12003,11513,9547,9135,42198
72,Iraq,2,2016,IRQ-16/3884/ST/H/INGO/2575,9876,10699,8417,8417,37409,15066,38968,11585,12141,77760
72,Iraq,2,2016,IRQ-16/3884/ST/P/UN/2576,0,24000,0,6800,30800,0,36846,0,40148,76994
72,Iraq,2,2016,IRQ-16/3884/ST/H/INGO/2578,3873,6482,4575,4471,19401,3914,6549,4622,4517,19602
72,Iraq,2,2016,IRQ-16/3884/ST/F/UN/2582,1305,1080,1125,990,4500,1193,988,1029,906,4116
72,Iraq,2,2016,IRQ-16/3884/ST/H/UN/2588,0,216459,0,21400,237859,0,222218,0,25365,247583
72,Iraq,2,2016,IRQ-16/3884/ST/NFIs/UN/2589,5066,5946,5505,5505,22022,6857,7759,5437,5299,25352
72,Iraq,2,2016,IRQ-16/3884/ST/H/UN/2590,16065,27247,9844,9844,63000,25081,31521,21466,22494,100562
72,Iraq,2,2016,IRQ-16/3884/ST/WASH/INGO/2593,10702,11138,9878,10282,42000,17856,18588,19347,20139,75930
72,Iraq,2,2016,IRQ-16/3884/ST/CCCM/UN/2594,200,200,200,200,800,584,584,482,472,2122
72,Iraq,2,2016,IRQ-16/3884/ST/H/NGO/2609,1203,1191,814,792,4000,1504,1489,1017,990,5000
72,Iraq,2,2016,IRQ-16/3884/ST/P/INGO/2610,50,50,4312,4313,8725,96,152,5611,4659,10518
72,Iraq,2,2016,IRQ-16/3884/ST/NFIs/NGO/2611,936,897,1024,1060,3917,936,897,1024,1060,3917
72,Iraq,2,2016,IRQ-16/3884/ST/F/NGO/2619,2300,2190,1875,1800,8165,2031,2465,1874,3236,9606
72,Iraq,2,2016,IRQ-16/3884/ST/CCS/UN/2630,188,0,0,0,188,188,0,0,0,188
72,Iraq,2,2016,IRQ-16/3884/ST/WASH/INGO/2632,7223,7825,1584,1718,18350,8770,14616,6244,7373,37003
72,Iraq,2,2016,IRQ-16/3884/ST/P/INGO/2633,6612,7389,2722,2722,19445,5250,3118,7152,10172,25692
72,Iraq,2,2016,IRQ-16/3884/ST/P/INGO/2634,2040,3360,2040,3160,10600,1637,1692,1691,1650,6670
72,Iraq,2,2016,IRQ-16/3884/ST/NFIs/UN/2639,404,606,942,1413,3365,404,606,942,1413,3365
72,Iraq,2,2016,IRQ-16/3884/ST/WASH/INGO/2647,1870,1946,1658,1726,7200,1887,1969,1678,1747,7281
72,Iraq,2,2016,IRQ-16/3884/ST/NFIs/INGO/2649,2242,2073,2242,1904,8461,2206,2802,2292,2792,10092
72,Iraq,2,2016,IRQ-16/3884/ST/CASH/INGO/2655,450,450,450,450,1800,492,516,434,419,1861
72,Iraq,2,2016,IRQ-16/3884/ST/WASH/INGO/2656,7377,7377,6285,6285,27324,2957,2957,2518,2518,10950
72,Iraq,2,2016,IRQ-16/3884/ST/P/INGO/2657,875,875,2200,2200,6150,1091,895,2417,2115,6518
72,Iraq,2,2016,IRQ-16/3884/ST/NFIs/INGO/2661,1011,1050,894,933,3888,1052,1159,807,902,3920
72,Iraq,2,2016,IRQ-16/3884/ST/WASH/INGO/2662,6423,6722,5729,5926,24800,10055,10442,8894,9282,38673
72,Iraq,2,2016,IRQ-16/3884/ST/CASH/INGO/2666,1756,1829,1272,1323,6180,1522,1844,1521,1470,6357
72,Iraq,2,2016,IRQ-16/3884/ST/WASH/INGO/2668,3176,2816,3580,3175,12747,0,0,0,0,0
72,Iraq,2,2016,IRQ-16/3884/ST/H/UN/2669,104370,108630,69580,72420,355000,139834,145541,93222,97028,475625
72,Iraq,2,2016,IRQ-16/3884/ST/WASH/INGO/2670,4300,4838,3400,3782,16320,11840,12071,10025,10202,44138
72,Iraq,2,2016,IRQ-16/3884/ST/NFIs/INGO/2672,2690,2806,1952,2032,9480,2700,2829,3030,2834,11393
72,Iraq,2,2016,IRQ-16/3884/ST/P/UN/2673,75,75,0,0,150,62,70,0,0,132
72,Iraq,2,2016,IRQ-16/3884/ST/WASH/INGO/2674,26500,31800,23850,23850,106000,27650,32900,24250,24800,109600
72,Iraq,2,2016,IRQ-16/3884/ST/CCCM/INGO/2675,200,200,0,0,400,200,200,0,0,400
72,Iraq,2,2016,IRQ-16/3884/ST/NFIs/O/2681,1885,1811,1512,1452,6660,1865,1798,1532,1465,6660
72,Iraq,2,2016,IRQ-16/3884/ST/WASH/O/2682,3536,3396,2835,2724,12491,2854,2714,2270,2153,9991
72,Iraq,2,2016,IRQ-16/3884/ST/CCCM/INGO/2685,1570,1630,1380,1440,6020,8128,8440,7190,7503,31261
72,Iraq,2,2016,IRQ-16/3884/ST/F/INGO/2690,11385,17710,15813,18342,63250,6350,9730,10680,11400,38160
72,Iraq,2,2016,IRQ-16/3884/ST/H/UN/2691,0,111360,151175,148381,410916,0,76064,137773,132595,346432
72,Iraq,2,2016,IRQ-16/3884/ST/CCS/INGO/2695,200,200,0,0,400,200,200,0,0,400
72,Iraq,2,2016,IRQ-16/3884/ST/WASH/UN/2703,46958,57393,46956,57393,208700,57150,69850,57150,69850,254000
72,Iraq,2,2016,IRQ-16/3884/ST/ELSC/INGO/2795,760,789,672,701,2922,609,617,933,865,3024
72,Iraq,2,2016,IRQ-16/3884/ST/ELSC/INGO/2798,1249,1458,1146,1354,5207,1194,1078,1057,1321,4650
72,Iraq,2,2016,IRQ-16/3884/ST/E/UN/2869,320,330,15000,15000,30650,0,0,8768,8424,17192
72,Iraq,2,2016,IRQ-16/3884/ST/P/INGO/3131,4591,10712,4591,10711,30605,18273,20004,9718,22292,70287
72,Iraq,2,2016,IRQ-16/3884/ST/H/INGO/3132,29468,52633,1905,2050,86056,40352,50971,11711,12586,115620
72,Iraq,1,2016,IRQ-16/3884/R/CCCM/INGO/3154,4600,6500,5200,5300,21600,4831,4873,3496,3703,16903
72,Iraq,1,2016,IRQ-16/3884/R/CCCM/UN/3158,1380,1620,1440,1560,6000,930,1209,1355,1690,5184
72,Iraq,1,2016,IRQ-16/3884/R/H-RRM/UN/3361,0,169000,0,18500,187500,0,141400,0,15540,156940
72,Iraq,1,2016,IRQ-16/3884/R/WASH/UN/3366,22500,27500,22500,27500,100000,22391,27370,22391,27370,99522
72,Iraq,1,2016,IRQ-16/3884/R/RRM/UN/3403,49410,49410,43920,40260,183000,47367,47367,42105,38596,175435
72,Iraq,1,2016,IRQ-16/3884/R/H/UN/3404,0,60000,86700,83300,230000,0,52940,78540,75460,206940
72,Iraq,2,2016,IRQ-16/3884/S/F/NGO/3486,3810,3966,3246,3378,14400,3404,3225,3665,4340,14634
72,Iraq,2,2016,IRQ-16/3884/S/H/NGO/3494,18043,17863,12214,11880,60000,20791,20587,14073,13690,69141
72,Iraq,2,2016,IRQ-16/3884/S/F/NGO/3503,11000,14500,20250,20250,66000,19567,13666,17735,17737,68705
72,Iraq,2,2016,IRQ-16/3884/S/H/INGO/3509,1570,1203,460,462,3695,8,6,3,3,20
72,Iraq,2,2016,IRQ-16/3884/S/H/INGO/3528,8640,10440,8460,8460,36000,7760,9918,7614,8206,33498
72,Iraq,2,2016,IRQ-16/3884/S/E/INGO/3536,634,634,2500,2500,6268,1465,1105,6856,6144,15570
72,Iraq,2,2016,IRQ-16/3884/S/H/NGO/3545,2184,2340,1560,1716,7800,4434,4398,1400,1274,11506
72,Iraq,2,2016,IRQ-16/3884/S/WASH-H-NFIs-F/INGO/3549,1320,1260,1782,1638,6000,2276,2172,3102,2793,10343
72,Iraq,2,2016,IRQ-16/3884/S/NFIs/NGO/3550,610,715,1850,2020,5195,1348,1463,1762,2068,6641
72,Iraq,2,2016,IRQ-16/3884/S/CASH/INGO/3551,1493,1727,1708,1627,6555,1544,1786,1818,1733,6881
72,Iraq,2,2016,IRQ-16/3884/S/F/NGO/3566,1444,1387,1500,2300,6631,1326,1266,1898,2062,6552
72,Iraq,2,2016,IRQ-16/3884/S/P/INGO/3579,2100,3500,2400,2900,10900,2572,2144,2060,1899,8675
72,Iraq,2,2016,IRQ-16/3884/S/WASH/UN/3581,56250,68750,56250,68750,250000,57166,59500,50695,52764,220125
72,Iraq,2,2016,IRQ-16/3884/S/F/INGO/3646,10736,11340,9472,9852,41400,10804,11245,9581,9972,41602
72,Iraq,2,2016,IRQ-16/3884/S/H-P/INGO/3650,7584,12696,1896,3024,25200,5703,11195,5723,9315,31936
72,Iraq,2,2016,IRQ-16/3884/S/NFIs/INGO/3656,5515,5334,5176,5005,21030,8829,8539,8286,8012,33666
72,Iraq,2,2016,IRQ-16/3884/S/P/UN/3660,7000,7000,11500,11500,37000,423,444,6126,7809,14802
72,Iraq,2,2016,IRQ-16/3884/S/P/INGO/3664,87500,87500,87500,87500,350000,87500,87500,87500,87500,350000
72,Iraq,2,2016,IRQ-16/3884/S/P/UN/3665,0,95000,0,13000,108000,0,50553,0,43153,93706
72,Iraq,2,2016,IRQ-16/3884/S/RRM/UN/3668,0,86400,0,21600,108000,0,89856,0,22464,112320
72,Iraq,2,2016,IRQ-16/3884/S/NFIs-H-F/INGO/3671,11906,12899,9355,10135,44295,9840,10644,7718,8377,36579
72,Iraq,2,2016,IRQ-16/3884/S/E/NGO/3673,70,70,1000,1000,2140,84,35,1186,974,2279
72,Iraq,2,2016,IRQ-16/3884/S/WASH/NGO/3674,150,600,300,450,1500,150,600,300,450,1500
72,Iraq,2,2016,IRQ-16/3884/S/H/UN/3680,0,84000,3150,21000,108150,0,96861,3214,24215,124290
72,Iraq,2,2016,IRQ-16/3884/S/CASH/INGO/3683,1336,1336,1188,1090,4950,997,1016,1334,1232,4579
72,Iraq,2,2016,IRQ-16/3884/S/NFIs/INGO/3689,2645,2645,5290,5290,15870,926,913,67,68,1974
72,Iraq,2,2016,IRQ-16/3884/S/P-E/INGO/3693,3120,7080,8000,8000,26200,11887,13158,34153,31029,90227
72,Iraq,2,2016,IRQ-16/3884/S/WASH/INGO/3694,2493,2595,2211,2301,9600,5066,5498,4256,4478,19298
72,Iraq,2,2016,IRQ-16/3884/S/NFIs/INGO/3695,2294,3441,2693,4040,12468,815,1194,958,1413,4380
72,Iraq,2,2016,IRQ-16/3884/S/F-NFIs/NGO/3699,2624,2654,2378,2244,9900,2624,2654,2378,2244,9900
72,Iraq,2,2016,IRQ-16/3884/S/F/NGO/3702,7314,11766,6360,6360,31800,7182,11504,6277,6310,31273
72,Iraq,2,2016,IRQ-16/3884/S/NFIs/INGO/3707,2000,2000,4000,4000,12000,8418,7666,6708,6061,28853
72,Iraq,2,2016,IRQ-16/3884/S/NFIs/INGO/3708,2925,3038,2587,2700,11250,5048,5016,4480,4453,18997
72,Iraq,2,2016,IRQ-16/3884/S/NFIs-WASH/INGO/3709,1000,1000,2000,2000,6000,1000,1000,2000,2000,6000
72,Iraq,2,2016,IRQ-16/3884/S/CCCM/INGO/3710,16324,16110,22896,24670,80000,20889,20615,29299,31569,102372
72,Iraq,2,2016,IRQ-16/3884/S/WASH/INGO/3717,3577,3577,3048,3048,13250,1674,2347,2950,2997,9968
72,Iraq,2,2016,IRQ-16/3884/S/WASH/INGO/3718,2500,2500,5000,5000,15000,28794,28794,23652,21596,102836
72,Iraq,2,2016,IRQ-16/3884/S/F-NFIs/INGO/3720,1240,1240,2480,2480,7440,2185,2185,4370,4370,13110
72,Iraq,2,2016,IRQ-16/3884/S/P/NGO/3722,37550,37550,37500,37500,150100,130000,120000,128000,122000,500000
72,Iraq,2,2016,IRQ-16/3884/S/NFIs/INGO/3727,450,450,450,450,1800,150,165,150,160,625
72,Iraq,2,2016,IRQ-16/3884/S/WASH/INGO/3729,5616,5832,5184,4968,21600,3551,4090,4865,4803,17309
72,Iraq,2,2016,IRQ-16/3884/S/WASH/INGO/3731,6125,7350,5512,5513,24500,7050,8460,6344,6346,28200
72,Iraq,2,2016,IRQ-16/3884/S/CCCM/INGO/3733,200,200,0,0,400,750,750,0,0,1500
72,Iraq,2,2016,IRQ-16/3884/S/WASH/INGO/3735,17547,17547,16197,16197,67488,18860,18860,17409,17409,72538
72,Iraq,2,2016,IRQ-16/3884/S/F/NGO/3740,11025,12075,13650,15750,52500,13779,13976,15851,14668,58274
72,Iraq,2,2016,IRQ-16/3884/S/E/INGO/3746,40,40,1700,1700,3480,92,79,1700,1700,3571
72,Iraq,2,2016,IRQ-16/3884/S/H/INGO/3776,8040,8710,3960,4290,25000,7477,8100,3683,3990,23250
72,Iraq,2,2016,IRQ-16/3884/S/NFIs/NGO/3888,4380,5050,1642,1928,13000,4494,5178,1694,1963,13329
72,Iraq,2,2016,IRQ-16/3884/S/H/INGO/3892,1393,1333,1352,1969,6047,1013,969,983,1432,4397
72,Iraq,2,2016,IRQ-16/3884/S/F/NGO/3907,1159,1390,1201,1250,5000,4353,4440,4370,4237,17400
72,Iraq,2,2016,IRQ-16/3884/S/WASH/NGO/3931,936,936,1014,1014,3900,813,860,1123,1191,3987
72,Iraq,2,2016,IRQ-16/3884/S/H/NGO/3932,7219,7143,4932,4706,24000,3249,3213,2220,2118,10800
72,Iraq,2,2016,IRQ-16/3884/S/NFIs/UN/3936,23364,31150,46726,54514,155754,30995,41327,61990,72322,206634
72,Iraq,2,2016,IRQ-16/3884/S/E/INGO/3944,60,60,2685,1790,4595,70,50,4222,4018,8360
72,Iraq,2,2016,IRQ-16/3884/S/P/UN/3950,3165,6990,3150,6975,20280,40383,50828,42708,50684,184603
72,Iraq,2,2016,IRQ-16/3884/S/WASH/INGO/3951,2000,2500,2500,3000,10000,2100,2700,3500,3700,12000
72,Iraq,2,2016,IRQ-16/3884/S/NFIs/INGO/3953,2498,3529,4164,4167,14358,4421,4542,7134,5362,21459
72,Iraq,2,2016,IRQ-16/3884/S/WASH/INGO/3954,1294,1346,2020,1940,6600,2098,2378,3018,2863,10357
72,Iraq,2,2016,IRQ-16/3884/S/CASH/INGO/3956,720,884,1598,1598,4800,1293,1326,1435,1474,5528
72,Iraq,2,2016,IRQ-16/3884/S/P/INGO/3959,3430,3570,5159,5369,17528,11012,11007,31612,29740,83371
72,Iraq,2,2016,IRQ-16/3884/S/E/INGO/3965,517,713,2100,2100,5430,198,47,7325,6280,13850
72,Iraq,2,2016,IRQ-16/3884/S/WASH/NGO/3966,550,650,550,650,2400,422,459,525,484,1890
72,Iraq,2,2016,IRQ-16/3884/S/NFIs/UN/3967,25000,30000,33000,32000,120000,25000,30000,33000,32000,120000
72,Iraq,2,2016,IRQ-16/3884/S/E/INGO/3971,26,26,6784,4856,11692,126,95,7603,6683,14507
72,Iraq,2,2016,IRQ-16/3884/S/WASH/UN/3975,2570,3430,2570,3430,12000,894,984,1489,1433,4800
72,Iraq,2,2016,IRQ-16/3884/S/WASH/INGO/3977,2162,2247,2384,2207,9000,2877,2907,2777,2673,11234
72,Iraq,2,2016,IRQ-16/3884/S/WASH/NGO/3984,2000,2000,3000,3000,10000,1854,2146,2850,3150,10000
72,Iraq,2,2016,IRQ-16/3884/S/CCS/INGO/4207,50,50,26,26,152,50,50,26,26,152
72,Iraq,2,2016,IRQ-16/3884/S/WASH/UN/4419,12150,14850,12150,14850,54000,24750,24750,20250,30250,100000
72,Iraq,1,2017,IRQ-17/3884/R/F/NGO/4719,650,280,50,20,1000,625,375,0,0,1000
72,Iraq,1,2017,IRQ-17/3884/R/P/NGO/4757,600,600,0,850,2050,633,679,0,2076,3388
72,Iraq,1,2017,IRQ-17/3884/R/WASH/NGO/4851,2760,2285,3150,3100,11295,2981,2297,3305,3376,11959
72,Iraq,1,2017,IRQ-17/3884/R/ELSC/NGO/4943,90,50,45,15,200,134,66,0,0,200
72,Iraq,1,2017,IRQ-17/3884/R/WASH/NGO/4949,400,300,2405,1595,4700,0,0,0,0,0
72,Iraq,1,2017,IRQ-17/3884/R/E/NGO/4951,13,13,3593,4192,7811,13,13,3593,4192,7811
72,Iraq,1,2017,IRQ-17/3884/R/NFIs/NGO/4953,105,165,390,440,1100,204,250,280,374,1108
72,Iraq,1,2017,IRQ-17/3884/R/ELSC/NGO/4957,150,100,30,20,300,162,138,0,0,300
72,Iraq,1,2017,IRQ-17/3884/R/P/NGO/4967,700,5900,600,1600,8800,638,770,486,759,2653
72,Iraq,1,2017,IRQ-17/3884/R/P/NGO/4971,600,2500,2200,2200,7500,4224,4463,5636,5905,20228
72,Iraq,1,2017,IRQ-17/3884/R/P/NGO/4972,6000,6000,8000,8000,28000,10589,8842,26234,27508,73173
72,Iraq,1,2017,IRQ-17/3884/R/H/NGO/4974,12841,13367,1270,1322,28800,12680,12200,3560,3740,32180
72,Iraq,1,2017,IRQ-17/3884/R/P/NGO/4976,4000,500,400,400,5300,2075,770,1584,1167,5596
72,Iraq,1,2017,IRQ-17/3884/IHPF 2017 RA/WASH/INGO/5069,11250,13500,10125,10125,45000,8815,13223,15536,17519,55093
72,Iraq,2,2017,IRQ-17/3884/ST/WASH/INGO/5364,12985,13515,11515,11985,50000,37424,39376,34165,35363,146328
72,Iraq,2,2017,IRQ-17/3884/ST/P/INGO/5377,6000,6000,9000,9000,30000,6685,6112,9968,9275,32040
72,Iraq,2,2017,IRQ-17/3884/ST/H/INGO/5393,11760,12322,9296,8871,42249,30037,48196,18367,19916,116516
72,Iraq,2,2017,IRQ-17/3884/ST/H/NGO/5411,8908,9550,6364,7002,31824,25270,33134,9289,9713,77406
72,Iraq,2,2017,IRQ-17/3884/ST/H/INGO/5423,10267,12053,11160,11160,44640,10496,11707,10646,8464,41313
72,Iraq,2,2017,IRQ-17/3884/ST/NFIs/INGO/5434,2126,2126,4252,4252,12756,2126,2126,4252,4252,12756
72,Iraq,2,2017,IRQ-17/3884/ST/E/NGO/5435,60,58,1110,1110,2338,81,37,1748,1657,3523
72,Iraq,2,2017,IRQ-17/3884/ST/H/NGO/5440,3474,3437,2374,2265,11550,1955,1934,1336,1275,6500
72,Iraq,2,2017,IRQ-17/3884/ST/F/INGO/5453,2126,2126,4252,4252,12756,2138,2138,4276,4276,12828
72,Iraq,2,2017,IRQ-17/3884/ST/WASH/INGO/5456,0,0,1802,1598,3400,0,0,3095,4155,7250
72,Iraq,2,2017,IRQ-17/3884/ST/P/INGO/5466,7160,9770,4900,4900,26730,8573,8108,2387,2135,21203
72,Iraq,2,2017,IRQ-17/3884/ST/P/INGO/5470,2574,2574,1615,1615,8378,3197,3602,4193,4836,15828
72,Iraq,2,2017,IRQ-17/3884/ST/CCCM/NGO/5483,15840,14400,20160,21600,72000,15840,14400,20160,21600,72000
72,Iraq,2,2017,IRQ-17/3884/ST/F/INGO/5487,16651,15998,14184,13629,60462,18946,18257,16189,15500,68892
72,Iraq,2,2017,IRQ-17/3884/ST/H/UN/5490,11173,14040,9565,10022,44800,9473,15002,10844,11326,46645
72,Iraq,2,2017,IRQ-17/3884/ST/WASH/INGO/5491,20986,22736,8162,8842,60726,13233,15124,4915,4537,37809
72,Iraq,2,2017,IRQ-17/3884/ST/CCCM/INGO/5493,34190,35505,30245,31560,131500,46808,49972,50842,50089,197711
72,Iraq,2,2017,IRQ-17/3884/ST/WASH/NGO/5504,7920,7200,10180,10700,36000,7920,7200,10180,10700,36000
72,Iraq,2,2017,IRQ-17/3884/ST/NFIs/INGO/5505,1452,1715,1707,1726,6600,1185,1285,1238,1226,4934
72,Iraq,2,2017,IRQ-17/3884/ST/WASH/INGO/5509,8884,8480,10903,12114,40381,11100,10595,13623,15136,50454
72,Iraq,2,2017,IRQ-17/3884/ST/P/UN/5535,5840,32650,5800,11460,55750,7309,26888,8709,18203,61109
72,Iraq,2,2017,IRQ-17/3884/ST/WASH/INGO/5538,4400,4200,6000,5400,20000,19810,18910,26744,24583,90047
72,Iraq,2,2017,IRQ-17/3884/ST/CCS/UN/5541,38714,10291,391,104,49500,24329,12168,394,135,37026
72,Iraq,2,2017,IRQ-17/3884/ST/CCS/INGO/5543,125000,125000,125000,125000,500000,125000,125000,125000,125000,500000
72,Iraq,2,2017,IRQ-17/3884/ST/P-E/INGO/5546,6000,6000,3750,3750,19500,7143,6480,5083,4482,23188
72,Iraq,2,2017,IRQ-17/3884/ST/WASH/INGO/5558,6000,8500,7000,8500,30000,6720,10080,10080,15120,42000
72,Iraq,2,2017,IRQ-17/3884/ST/E/NGO/5571,173,191,4312,3628,8304,0,0,0,0,0
72,Iraq,2,2017,IRQ-17/3884/ST/P/INGO/5573,4935,4725,10420,10570,30650,8861,10202,21483,20603,61149
72,Iraq,2,2017,IRQ-17/3884/ST/H/UN/5579,0,24500,980,6125,31605,0,26312,1023,6712,34047
72,Iraq,2,2017,IRQ-17/3884/ST/NFIs/INGO/5582,2730,2835,2415,2520,10500,3448,3536,3706,3957,14647
72,Iraq,2,2017,IRQ-17/3884/ST/CCCM/INGO/5596,2250,3000,4500,5250,15000,400,431,648,576,2055
72,Iraq,2,2017,IRQ-17/3884/ST/WASH/INGO/5626,1365,1733,2227,2175,7500,4076,5346,6824,6592,22838
72,Iraq,2,2017,IRQ-17/3884/ST/LOGs/UN/5627,0,0,0,30,30,0,0,0,30,30
72,Iraq,2,2017,IRQ-17/3884/ST/WASH/INGO/5628,2626,2727,2424,2323,10100,1750,2181,3071,3092,10094
72,Iraq,2,2017,IRQ-17/3884/ST/H/NGO/5631,6950,6874,5181,4095,23100,6153,6085,4587,3625,20450
72,Iraq,2,2017,IRQ-17/3884/ST/CASH/INGO/5636,918,882,1323,1377,4500,1120,1075,1603,1669,5467
72,Iraq,2,2017,IRQ-17/3884/ST/H/INGO/5644,4891,4668,5780,6891,22230,4925,4701,5820,6940,22386
72,Iraq,2,2017,IRQ-17/3884/ST/NFIs/INGO/5645,1560,1560,1440,1440,6000,2000,2133,2554,2293,8980
72,Iraq,2,2017,IRQ-17/3884/ST/H/INGO/5648,3900,3900,3600,3600,15000,3900,3900,3600,3600,15000
72,Iraq,2,2017,IRQ-17/3884/ST/WASH/INGO/5650,1370,1508,2754,2868,8500,90,200,15,76,381
72,Iraq,2,2017,IRQ-17/3884/ST/E/INGO/5653,106,210,1670,1930,3916,65,101,3862,4285,8313
72,Iraq,2,2017,IRQ-17/3884/ST/P/INGO/5654,1073,1071,1500,1500,5144,831,1190,1634,1636,5291
72,Iraq,2,2017,IRQ-17/3884/ST/P/INGO/5656,277,237,1219,931,2664,306,301,1211,1049,2867
72,Iraq,2,2017,IRQ-17/3884/ST/CASH/INGO/5658,929,929,931,931,3720,1149,1250,974,916,4289
72,Iraq,2,2017,IRQ-17/3884/ST/H/NGO/5663,12932,13458,1279,1331,29000,13130,21190,6773,5553,46646
72,Iraq,2,2017,IRQ-17/3884/ST/H/INGO/5668,16880,17570,14970,15580,65000,9243,11030,8654,11821,40748
72,Iraq,2,2017,IRQ-17/3884/ST/H/INGO/5671,9450,9450,6300,6300,31500,10250,9500,4805,3114,27669
72,Iraq,2,2017,IRQ-17/3884/ST/P/NGO/5673,150,541,0,225,916,172,3825,0,2333,6330
72,Iraq,2,2017,IRQ-17/3884/ST/F/INGO/5675,9206,9160,9152,8482,36000,9814,9762,9754,9040,38370
72,Iraq,2,2017,IRQ-17/3884/ST/WASH/INGO/5678,3750,3750,4750,4750,17000,3542,3015,5867,4160,16584
72,Iraq,2,2017,IRQ-17/3884/ST/NFIs/O/5683,3056,2938,2452,2354,10800,3024,2916,2484,2376,10800
72,Iraq,2,2017,IRQ-17/3884/ST/E/INGO/5686,1580,1660,4000,4000,11240,112,67,2197,1411,3787
72,Iraq,2,2017,IRQ-17/3884/ST/F/UN/5693,71340,59040,61500,54120,246000,0,0,0,0,0
72,Iraq,2,2017,IRQ-17/3884/ST/H/INGO/5694,2114,2200,2481,2384,9179,3500,3600,7200,7654,21954
72,Iraq,2,2017,IRQ-17/3884/ST/WASH/INGO/5706,1218,1470,630,882,4200,1530,1785,765,1020,5100
72,Iraq,2,2017,IRQ-17/3884/ST/CASH/INGO/5709,6225,5980,5303,5094,22602,5563,5694,5245,5230,21732
72,Iraq,2,2017,IRQ-17/3884/ST/EL/INGO/5720,844,844,770,878,3336,1400,1838,928,1059,5225
72,Iraq,2,2017,IRQ-17/3884/ST/NFIs/INGO/5721,2401,2974,3293,3220,11888,2002,2931,3688,3629,12250
72,Iraq,2,2017,IRQ-17/3884/ST/NFIs/NGO/5723,1554,1666,1354,1466,6040,2421,2387,2136,2013,8957
72,Iraq,2,2017,IRQ-17/3884/ST/EL/NGO/5728,500,500,550,550,2100,28,30,32,36,126
72,Iraq,2,2017,IRQ-17/3884/ST/EL/INGO/5735,520,520,1040,1040,3120,860,870,580,598,2908
72,Iraq,2,2017,IRQ-17/3884/ST/P/INGO/5736,2390,2967,3164,2887,11408,6266,6920,2138,1877,17201
72,Iraq,2,2017,IRQ-17/3884/ST/WASH/INGO/5739,4802,4998,7203,7497,24500,4802,4998,7203,7497,24500
72,Iraq,2,2017,IRQ-17/3884/ST/E-P/INGO/5744,1250,1250,3800,3800,10100,1854,1651,6900,6794,17199
72,Iraq,2,2017,IRQ-17/3884/ST/WASH/UN/5751,52939,64879,55729,66453,240000,111291,122160,72907,81642,388000
72,Iraq,2,2017,IRQ-17/3884/ST/P/INGO/5752,1394,1388,2030,1890,6702,1174,1132,5485,4258,12049
72,Iraq,2,2017,IRQ-17/3884/ST/P/INGO/5753,3015,3015,2655,2655,11340,5584,5706,2056,2144,15490
72,Iraq,2,2017,IRQ-17/3884/ST/H/INGO/5754,9840,11890,9635,9635,41000,10631,13352,4157,4371,32511
72,Iraq,2,2017,IRQ-17/3884/ST/E-WASH-P/INGO/5757,4000,4000,20700,27300,56000,4000,4000,20700,27300,56000
72,Iraq,2,2017,IRQ-17/3884/ST/NFIs/UN/5760,1980,2160,1440,1620,7200,2448,2590,1656,2116,8810
72,Iraq,2,2017,IRQ-17/3884/ST/RRM/UN/5767,25970,27030,23030,23970,100000,23048,24160,26059,26733,100000
72,Iraq,2,2017,IRQ-17/3884/ST/E/INGO/5775,0,0,8000,8000,16000,0,0,8066,7950,16016
72,Iraq,1,2017,IRQ-17/3884/RA/P/UN/6206,0,115200,0,28800,144000,0,32000,0,8000,40000
72,Iraq,1,2017,IRQ-17/3884/R/P/UN/6862,330,2100,250,1095,3775,1852,4171,2431,2711,11165
72,Iraq,1,2017,IRQ-17/3884/R/P/INGO/6864,626,724,1621,1566,4537,2036,2457,3734,4144,12371
72,Iraq,1,2017,IRQ-17/3884/R/H/UN/6872,4860,5040,3960,4140,18000,17611,21401,11000,11530,61542
72,Iraq,1,2017,IRQ-17/3884/R/WASH/INGO/7100,4586,4774,4234,4406,18000,3821,4763,3594,3790,15968
72,Iraq,1,2017,IRQ-17/3884/R/P/INGO/7107,1012,1012,700,700,3424,793,1113,1054,1007,3967
72,Iraq,1,2017,IRQ-17/3884/R/WASH/NGO/7134,19500,19500,10500,10500,60000,4801,6080,2321,3076,16278
72,Iraq,1,2017,IRQ-17/3884/R/E/NGO/7154,107,107,1785,1786,3785,143,41,3928,2668,6780
72,Iraq,1,2017,IRQ-17/3884/R/H/UN/7172,3430,4252,2880,3157,13719,3972,4923,4587,4726,18208
72,Iraq,1,2017,IRQ-17/3884/R/H/INGO/7174,1500,2000,2000,2000,7500,1478,3508,2030,2390,9406
72,Iraq,1,2017,IRQ-17/3884/R/H/UN/7191,20000,19200,20800,20000,80000,54075,51912,56238,54075,216300
72,Iraq,1,2017,IRQ-17/3884/R/CASH/INGO/7200,1520,1461,1295,1244,5520,1414,1656,1502,1471,6043
72,Iraq,1,2017,IRQ-17/3884/R/P/INGO/7225,17000,17000,17000,17000,68000,128,227,559,346,1260
72,Iraq,1,2017,IRQ-17/3884/R/CASH/INGO/7229,765,978,1275,1232,4250,0,0,0,0,0
72,Iraq,1,2017,IRQ-17/3884/R/NFIs/INGO/7230,2753,3394,4103,4099,14349,3101,3796,3649,4183,14729
72,Iraq,1,2017,IRQ-17/3884/R/WASH/INGO/7232,1911,2425,3119,3045,10500,3465,4364,5508,5192,18529
72,Iraq,1,2017,IRQ-17/3884/R/P/INGO/7267,3000,3000,6000,6000,18000,174,160,44,32,410
72,Iraq,1,2017,IRQ-17/3884/R/NFIs/UN/7283,1000,1000,2000,2000,6000,500,500,1000,1000,3000
72,Iraq,1,2017,IRQ-17/3884/R/E/INGO/7300,54,54,2700,2700,5508,105,15,3740,2312,6172
72,Iraq,1,2017,IRQ-17/3884/R/P/INGO/7316,13,13,60,60,146,0,0,0,0,0
72,Iraq,1,2017,IRQ-17/3884/R7/NFIs/UN/7689,1800,2235,1510,1655,7200,1679,1952,2128,1971,7730
72,Iraq,1,2017,IRQ-17/3884/R7/NFIs/INGO/7695,1092,1134,945,1029,4200,665,869,827,872,3233
72,Iraq,1,2017,IRQ-17/3884/R7/NFIs/INGO/7699,2822,2938,3058,3182,12000,2275,2640,5150,5575,15640
72,Iraq,1,2017,IRQ-17/3884/R7/CCS/INGO/7720,43,43,42,42,170,40,20,5,5,70
72,Iraq,2,2018,IRQ-18/3884/SA1/P/NGO/8024,1000,1500,500,500,3500,140,340,837,547,1864
72,Iraq,2,2018,IRQ-18/3884/SA1/WASH/NGO/8066,239,340,8205,11345,20129,270,198,8095,11091,19654
72,Iraq,2,2018,IRQ-18/3884/SA1/H/INGO/8251,1209,1419,876,876,4380,2233,2703,1563,1529,8028
72,Iraq,2,2018,IRQ-18/3884/SA1/CASH/INGO/8308,972,864,936,828,3600,988,878,952,842,3660
72,Iraq,2,2018,IRQ-18/3884/SA1/H-P/INGO/8334,62,1948,1288,1650,4948,11,1737,2359,2257,6364
72,Iraq,2,2018,IRQ-18/3884/SA1/WASH/INGO/8341,6071,6050,5646,6233,24000,0,0,0,0,0
72,Iraq,2,2018,IRQ-18/3884/SA1/P/NGO/8420,4023,3587,0,0,7610,4511,1665,0,0,6176
72,Iraq,2,2018,IRQ-18/3884/SA1/H/INGO/8421,2633,4253,2747,2500,12133,3584,5780,3730,3394,16488
72,Iraq,2,2018,IRQ-18/3884/SA1/P/NGO/8427,122,1756,60,975,2913,2,4182,0,1382,5566
72,Iraq,2,2018,IRQ-18/3884/SA1/F/INGO/8430,970,1450,965,1445,4830,1317,1609,1004,953,4883
72,Iraq,2,2018,IRQ-18/3884/SA1/H/INGO/8436,1712,3088,1240,1160,7200,3054,4057,1548,1298,9957
72,Iraq,2,2018,IRQ-18/3884/SA1/NFIs/INGO/8437,1294,1302,1148,1194,4938,558,707,701,784,2750
72,Iraq,2,2018,IRQ-18/3884/SA1/WASH/NGO/8439,3774,4064,5750,5518,19106,691,713,1276,1264,3944
72,Iraq,2,2018,IRQ-18/3884/SA1/CCCM/INGO/8442,14076,13524,28152,27048,82800,793,750,690,750,2983
72,Iraq,2,2018,IRQ-18/3884/SA1/WASH/INGO/8450,3744,3744,4448,4196,16132,108,98,100,117,423
72,Iraq,2,2018,IRQ-18/3884/SA1/WASH/INGO/8464,3116,3244,2764,2876,12000,3551,3721,2950,3278,13500
72,Iraq,2,2018,IRQ-18/3884/SA1/WASH/INGO/8471,2727,2603,3347,3719,12396,0,0,0,0,0
72,Iraq,2,2018,IRQ-18/3884/SA1/H/NGO/8482,1805,1786,1233,1176,6000,1849,1830,1263,1206,6148
72,Iraq,2,2018,IRQ-18/3884/SA1/E/NGO/8486,1750,920,600,600,3870,347,125,1506,925,2903
72,Iraq,2,2018,IRQ-18/3884/SA1/E/INGO/8500,90,60,2500,2500,5150,10,20,2412,2533,4975
72,Iraq,2,2018,IRQ-18/3884/SA1/H/NGO/8508,15615,15444,11640,9201,51900,15763,15591,11751,9289,52394
72,Iraq,2,2018,IRQ-18/3884/SA1/H/INGO/8532,1000,1023,1970,1978,5971,526,386,253,323,1488
72,Iraq,2,2018,IRQ-18/3884/SA1/CCS/INGO/8543,125000,125000,125000,125000,500000,62500,62500,62500,62500,250000
72,Iraq,2,2018,IRQ-18/3884/SA1/H/NGO/8567,0,1200,0,0,1200,0,2093,0,0,2093
72,Iraq,2,2018,IRQ-18/3884/SA1/H/INGO/8570,200,5724,3612,3612,13148,0,1840,3217,3115,8172
72,Iraq,2,2018,IRQ-18/3884/SA1/P/NGO/8578,600,2000,400,600,3600,472,2424,244,1626,4766
72,Iraq,2,2018,IRQ-18/3884/SA1/F-EL/INGO/8582,3030,3050,2900,3020,12000,0,0,0,0,0
72,Iraq,2,2018,IRQ-18/3884/SA1/WASH/INGO/8597,6500,7800,5850,5850,26000,4658,6730,7247,7247,25882
73,Jordan,2,2015,JOR-14/DDA-3560/CP/NFI/INGO/1131,1170,1579,1579,1522,5850,954,1079,891,960,3884
73,Jordan,2,2015,JOR-14/DDA-3560/CP/NFI/INGO/1134,471,575,47,57,1150,158,477,472,431,1538
73,Jordan,2,2015,JOR-14/DDA-3560/CP/NFI/INGO/1135,390,424,0,0,814,345,583,488,437,1853
73,Jordan,1,2015,JOR-15/DDA-3560/RB/H/NGO/1481,250,4050,150,327,4777,260,9244,200,400,10104
73,Jordan,2,2015,JOR-15/DDA-3560/CFP615/H/INGO/1675,1241,4569,1437,1428,8675,1570,7653,380,367,9970
73,Jordan,2,2015,JOR-15/DDA-3560/CFP615/P/INGO/1687,24380,26105,33120,31395,115000,66409,51338,25825,19964,163536
73,Jordan,2,2015,JOR-15/DDA-3560/CFP615/H/INGO/1698,1350,1350,1150,1150,5000,1657,1305,634,426,4022
73,Jordan,2,2015,JOR-15/DDA-3560/CFP615/WASH/INGO/1700,275,275,2000,2000,4550,116,560,2324,6680,9680
73,Jordan,2,2015,JOR-15/DDA-3560/CFPO2015/BN/INGO/2050,523,537,562,578,2200,454,586,770,761,2571
73,Jordan,2,2015,JOR-15/DDA-3560/CFPO2015/BN/INGO/2051,680,1258,646,816,3400,1084,1275,1050,1044,4453
73,Jordan,2,2015,JOR-15/DDA-3560/CFPO2015/BN/INGO/2053,567,640,666,627,2500,626,819,699,668,2812
73,Jordan,2,2015,JOR-15/DDA-3560/CFPO2015/BN/INGO/2057,727,819,851,803,3200,667,902,801,830,3200
73,Jordan,2,2015,JOR-15/DDA-3560/CFPO2015/BN/INGO/2058,943,1025,1107,1025,4100,1073,1231,1842,1706,5852
73,Jordan,2,2015,JOR-15/DDA-3560/CFPO2015/BN/INGO/2061,619,735,906,836,3096,766,961,963,828,3518
73,Jordan,2,2015,JOR-15/DDA-3560/CFPO2015/BN/INGO/2064,765,760,758,717,3000,808,1014,1032,991,3845
73,Jordan,1,2015,JOR-15/DDA-3560/RB/P/INGO/2070,226,222,95,97,640,285,299,158,141,883
73,Jordan,1,2015,JOR-15/DDA-3560/RB/H/NGO/2110,60,25,2,3,90,80,26,6,3,115
73,Jordan,2,2015,JOR-15/DDA-3560/CFP Nov 2015/H/INGO/2131,15375,25678,19510,19967,80530,12330,20763,17342,17210,67645
73,Jordan,2,2015,JOR-15/DDA-3560/CFP Nov 2015/H/INGO/2149,1674,5616,1782,1728,10800,1352,8818,647,941,11758
73,Jordan,2,2015,JOR-15/DDA-3560/CFP Nov 2015/H/NGO/2186,200,600,0,0,800,236,564,0,0,800
73,Jordan,2,2015,JOR-15/DDA-3560/CFP Nov 2015/BN/INGO/2197,369,402,416,418,1605,361,489,488,456,1794
73,Jordan,2,2015,JOR-15/DDA-3560/CFP Nov 2015/WASH/INGO/2204,16541,17886,23029,21684,79140,16541,17886,23029,21684,79140
73,Jordan,2,2015,JOR-15/DDA-3560/CFP Nov 2015/Sh./INGO/2211,450,536,508,506,2000,540,680,787,765,2772
73,Jordan,2,2015,JOR-15/DDA-3560/CFP Nov 2015/H/NGO/2214,49,215,20,13,297,17,126,12,18,173
73,Jordan,2,2015,JOR-15/DDA-3560/CFP Nov 2015/EDU/INGO/2220,185,186,3369,3465,7205,185,186,3201,3164,6736
73,Jordan,2,2015,JOR-15/DDA-3560/CFP Nov 2015/BN/INGO/2222,730,910,946,914,3500,789,924,1202,1131,4046
73,Jordan,2,2015,JOR-15/DDA-3560/CBTF CFP 112015/SRP NFI /INGO/2229,1167,1227,823,864,4081,960,887,1448,1480,4775
73,Jordan,2,2015,JOR-15/DDA-3560/CBTF CFP 112015/SRP-H/NGO/2238,55,25,0,0,80,60,13,0,0,73
73,Jordan,2,2015,JOR-15/DDA-3560/CBTF CFP 112015/SRP ERL/INGO/2243,1479,170,51,0,1700,1001,967,0,0,1968
73,Jordan,2,2015,JOR-15/DDA-3560/CFP Nov 2015/H/NGO/2244,0,800,15,30,845,0,886,12,34,932
73,Jordan,2,2015,JOR-15/DDA-3560/CBTF CFP 112015/SRP-H/NGO/2246,1490,2775,1475,1475,7215,1795,2977,621,843,6236
73,Jordan,2,2015,JOR-15/DDA-3560/CBTF CFP 112015/SRP ERL/UN/2247,1479,170,51,0,1700,1530,170,0,0,1700
73,Jordan,2,2015,JOR-15/DDA-3560/CFP Nov 2015/EDU/INGO/2250,0,0,2500,2500,5000,0,0,2510,2499,5009
73,Jordan,2,2015,JOR-15/DDA-3560/CFP Nov 2015/BN/INGO/2251,1530,1531,1531,1531,6123,1600,1873,1665,1631,6769
73,Jordan,2,2015,JOR-15/DDA-3560/CBTF CFP 112015/SRP NFI /UN/2287,834,834,1666,1666,5000,2139,2189,1271,1212,6811
73,Jordan,1,2016,JOR-16/DDA-3560/Reserve16/SRP-H/NGO/2555,0,0,53760,53761,107521,0,0,61849,60375,122224
73,Jordan,2,2016,JOR-16/DDA-3560/CFP416/BN/INGO/2790,555,581,766,738,2640,498,676,806,756,2736
73,Jordan,2,2016,JOR-16/DDA-3560/CFP416/Sh./INGO/2791,451,561,584,564,2160,320,418,490,438,1666
73,Jordan,2,2016,JOR-16/DDA-3560/CFP416/BN/INGO/2806,405,461,618,591,2075,333,486,558,539,1916
73,Jordan,2,2016,JOR-16/DDA-3560/CFP416/Sh./INGO/2815,432,485,510,483,1910,402,580,605,508,2095
73,Jordan,2,2016,JOR-16/DDA-3560/CFP416/H/INGO/2833,3100,2435,1147,901,7583,3043,2756,1367,1114,8280
73,Jordan,2,2016,JOR-16/DDA-3560/CFP416/H/NGO/2836,391,414,177,177,1159,457,781,548,494,2280
73,Jordan,2,2016,JOR-16/DDA-3560/CFP416/SRP-Food/INGO/2838,56925,81675,49500,59400,247500,52129,74795,45330,54396,226650
73,Jordan,2,2016,JOR-16/DDA-3560/CFP416/BN/INGO/2853,489,544,560,531,2124,353,461,489,429,1732
73,Jordan,2,2016,JOR-16/DDA-3560/CFP416/SRP-H/NGO/2854,8,4,0,0,12,0,0,0,0,0
73,Jordan,2,2016,JOR-16/DDA-3560/CFP416/SRP-N/NGO/2861,500,1600,0,500,2600,579,1760,0,653,2992
73,Jordan,2,2016,JOR-16/DDA-3560/CFP416/Sh./INGO/2875,596,670,694,656,2616,528,640,791,754,2713
73,Jordan,2,2016,JOR-16/DDA-3560/CFP416/H/NGO/2884,100,21,24,5,150,74,11,25,10,120
73,Jordan,2,2016,JOR-16/DDA-3560/CFP416/BN/INGO/2896,927,1051,1031,971,3980,719,920,1290,1213,4142
73,Jordan,2,2016,JOR-16/DDA-3560/CFP416/P-H/INGO/2897,760,775,323,331,2189,1025,1316,691,807,3839
73,Jordan,2,2016,JOR-16/DDA-3560/CFP416/SRP-H/NGO/2901,1582,2457,407,474,4920,2339,4048,659,672,7718
73,Jordan,2,2016,JOR-16/DDA-3560/CFP916/BN-P/INGO/3970,3793,3947,5027,5233,18000,4365,4521,5908,6149,20943
73,Jordan,2,2016,JOR-16/DDA-3560/CFP916/BN/INGO/3978,741,832,861,816,3250,873,961,875,794,3503
73,Jordan,2,2016,JOR-16/DDA-3560/CFP916/BN-Sh./INGO/3981,536,1092,971,971,3570,927,1076,1133,1071,4207
73,Jordan,2,2016,JOR-16/DDA-3560/CFP916/BN/INGO/4008,709,782,953,886,3330,667,743,879,881,3170
73,Jordan,2,2016,JOR-16/DDA-3560/CFP916/WASH/INGO/4009,2036,2422,3090,2871,10419,2059,2460,3125,2913,10557
73,Jordan,2,2016,JOR-16/DDA-3560/CFP916/BN/INGO/4010,1173,1220,1221,1271,4885,1256,1570,1557,1450,5833
73,Jordan,2,2016,JOR-16/DDA-3560/CFP916/P-BN/INGO/4039,4513,4701,6050,6336,21600,4445,4678,5981,6262,21366
73,Jordan,2,2016,JOR-16/DDA-3560/CFP916/P/NGO/4044,625,2000,625,750,4000,85,5391,0,794,6270
73,Jordan,2,2016,JOR-16/DDA-3560/CFP916/SRP NFI /INGO/4054,825,784,1237,1279,4125,1453,1463,2092,1939,6947
73,Jordan,2,2016,JOR-16/DDA-3560/CFP916/H/NGO/4059,57,226,59,112,454,344,536,368,285,1533
73,Jordan,2,2016,JOR-16/DDA-3560/CFP916/SRP-N/NGO/4123,500,2870,4004,3846,11220,13,3858,1652,1526,7049
73,Jordan,2,2016,JOR-16/DDA-3560/CFP916/SRP Pro/INGO/4124,2973,3228,4075,4136,14412,1635,1841,7396,7133,18005
73,Jordan,2,2016,JOR-16/DDA-3560/CFP916/BN/INGO/4130,886,1092,1132,1040,4150,646,814,1052,990,3502
73,Jordan,2,2016,JOR-16/DDA-3560/CFP916/SRP NFI /INGO/4134,2470,2470,1940,1940,8820,2161,2060,2701,3033,9955
73,Jordan,2,2016,JOR-16/DDA-3560/CFP916/H/NGO/4136,40,200,107,80,427,41,236,113,68,458
73,Jordan,2,2016,JOR-16/DDA-3560/CFP916/SRP-H/INGO/4175,18,15,2,0,35,19,19,2,0,40
73,Jordan,2,2016,JOR-16/DDA-3560/CFP916/SRP NFI /NGO/4185,0,0,4570,3046,7616,0,0,4570,3046,7616
73,Jordan,2,2017,JOR-17/DDA-3560/J-CfPMar17/P/INGO/5363,350,400,644,306,1700,83,478,401,259,1221
73,Jordan,2,2017,JOR-17/DDA-3560/J-CfPMar17/H/INGO/5415,72,392,40,73,577,10,577,39,45,671
73,Jordan,2,2017,JOR-17/DDA-3560/J-CfPMar17/BN/INGO/5422,2805,3029,2356,3029,11219,6788,8117,11652,10449,37006
73,Jordan,2,2017,JOR-17/DDA-3560/J-CfPMar17/P/NGO/5475,9,1110,700,900,2719,704,1754,2390,2453,7301
73,Jordan,2,2017,JOR-17/DDA-3560/J-CfPMar17/P/NGO/5500,74,1011,967,963,3015,32,1496,1375,1472,4375
73,Jordan,2,2017,JOR-17/DDA-3560/J-CfPMar17/Sh.-P/INGO/5620,452,528,512,508,2000,489,570,638,613,2310
73,Jordan,2,2017,JOR-17/DDA-3560/SS-CfPMar17/SRP-Food/NGO/5634,285,15,0,0,300,277,23,0,0,300
73,Jordan,2,2017,JOR-17/DDA-3560/J-CfPMar17/H/INGO/5681,178,177,65,65,485,250,274,51,29,604
73,Jordan,2,2017,JOR-17/DDA-3560/SS-CfPMar17/SRP-H/INGO/5700,15,14,2,1,32,33,32,0,0,65
73,Jordan,2,2017,JOR-17/DDA-3560/SS-CfPMar17/SRP NFI /INGO/5747,1210,1150,1815,1875,6050,2072,2166,1802,1537,7577
73,Jordan,2,2017,JOR-17/DDA-3560/J-CfPMar17/WASH/INGO/5771,540,577,527,506,2150,1167,1168,735,794,3864
73,Jordan,2,2017,JOR-17/DDA-3560/J-CfPMar17/H/INGO/5788,245,352,114,89,800,343,425,212,209,1189
73,Jordan,2,2017,JOR-17/DDA-3560/SS-CfPMar17/SRP-H/INGO/5794,2062,2063,1980,2145,8250,2200,2420,1780,2000,8400
73,Jordan,2,2017,JOR-17/DDA-3560/J-CfPMar17/Sh./INGO/5800,444,545,542,520,2051,406,450,609,575,2040
73,Jordan,2,2017,JOR-17/DDA-3560/SS-CfPMar17/SRP NFI /NGO/5806,833,745,822,760,3160,833,745,822,760,3160
73,Jordan,2,2017,JOR-17/DDA-3560/SS-CfPMar17/SRP-Edu/NGO/5811,0,6,97,146,249,0,0,12,21,33
73,Jordan,2,2017,JOR-17/DDA-3560/J-CfPMar17/H/NGO/5812,36,6,8,2,52,46,2,10,0,58
73,Jordan,2,2017,JOR-17/DDA-3560/SS-CfPMar17/SRP-Food/INGO/5815,6440,6720,7280,7560,28000,6440,6720,7280,7560,28000
73,Jordan,2,2017,JOR-17/DDA-3560/SS-CfPMar17/SRP-Food/UN/5816,1500,1500,0,0,3000,1700,1700,0,0,3400
73,Jordan,2,2017,JOR-17/DDA-3560/J-CfPMar17/WASH/INGO/5824,602,657,582,587,2428,593,563,622,589,2367
73,Jordan,2,2017,JOR-17/DDA-3560/J-CfPAug17/Sh./INGO/6870,309,322,382,372,1385,0,0,0,0,0
73,Jordan,2,2017,JOR-17/DDA-3560/J-CfPAug17/BN/INGO/6882,1100,1220,1244,1178,4742,850,1027,1426,1352,4655
73,Jordan,2,2017,JOR-17/DDA-3560/SS-CfPAug17/SRP NFI /INGO/6890,1338,1271,2006,2073,6688,1878,1953,2088,1858,7777
73,Jordan,2,2017,JOR-17/DDA-3560/J-CfPAug17/BN/INGO/6899,548,602,774,726,2650,438,595,1163,1003,3199
73,Jordan,2,2017,JOR-17/DDA-3560/J-CfPAug17/BN/INGO/6912,855,941,1201,1131,4128,856,1057,1346,1331,4590
73,Jordan,2,2017,JOR-17/DDA-3560/J-CfPAug17/H/NGO/6958,3,96,22,35,156,5,137,29,28,199
73,Jordan,1,2017,JOR-17/DDA-3560/RANOV2017/H/O/7620,147,165,6,12,330,140,184,3,7,334
73,Jordan,2,2018,JOR-18/DDA-3560/J-CfPApr18/H/INGO/8970,39,556,6,34,635,1,168,1,19,189
73,Jordan,2,2018,JOR-18/DDA-3560/J-CfPApr18/WASH/INGO/9110,1467,1634,2258,2120,7479,0,0,0,0,0
71,Lebanon,1,2015,LEB-15/DDA-3604/Win/S/INGO/1138,1164,1342,1341,1265,5112,1200,1383,1382,1303,5268
71,Lebanon,1,2015,LEB-15/DDA-3604/Win/S/INGO/1139,505,731,980,1109,3325,470,645,926,1046,3087
71,Lebanon,1,2015,LEB-15/DDA-3604/Win/S/INGO/1141,1901,1964,1204,1267,6336,2334,2510,2135,2249,9228
71,Lebanon,1,2015,LEB-15/DDA-3604/Win/S/NGO/1142,1909,2085,1009,1007,6010,1909,2085,1009,1007,6010
71,Lebanon,1,2015,LEB-15/DDA-3604/Win/S/INGO/1144,1473,1137,1455,1510,5575,1199,1403,1506,1451,5559
71,Lebanon,1,2015,LEB-15/DDA-3604/Win/S/INGO/1145,819,632,811,836,3098,814,1056,1224,1693,4787
71,Lebanon,1,2015,LEB-15/DDA-3604/Win/S/NGO/1146,4870,5520,9750,11163,31303,4870,5520,9750,11163,31303
71,Lebanon,1,2015,LEB-15/DDA-3604/Win/WASH/INGO/1147,475,368,469,488,1800,705,700,775,780,2960
71,Lebanon,2,2015,LEB-15/DDA-3604/Call for Proposals/FS/UN/1541,25,125,0,0,150,0,170,0,0,170
71,Lebanon,2,2015,LEB-15/DDA-3604/Call for Proposals/P/NGO/1555,0,0,90,90,180,0,0,109,71,180
71,Lebanon,2,2015,LEB-15/DDA-3604/Call for Proposals/H/INGO/1574,80,320,206,149,755,98,346,210,156,810
71,Lebanon,2,2015,LEB-15/DDA-3604/Call for Proposals/P/INGO/1575,1000,1000,750,750,3500,419,842,2025,1941,5227
71,Lebanon,2,2015,LEB-15/DDA-3604/Call for Proposals/P/INGO/1576,30,1780,33,733,2576,51,710,31,186,978
71,Lebanon,2,2015,LEB-15/DDA-3604/Call for Proposals/P/NGO/1577,400,210,50,40,700,553,298,54,33,938
71,Lebanon,2,2015,LEB-15/DDA-3604/Call for Proposals/P/NGO/1580,0,0,30,30,60,0,0,31,46,77
71,Lebanon,2,2015,LEB-15/DDA-3604/Call for Proposals/P/INGO/1594,498,656,632,644,2430,436,568,528,538,2070
71,Lebanon,2,2015,LEB-15/DDA-3604/Call for Proposals/E/NGO/1604,3,7,505,640,1155,0,0,3806,4376,8182
71,Lebanon,2,2015,LEB-15/DDA-3604/Call for Proposals/W/NGO/1606,6566,7373,4493,4608,23040,6566,7373,4493,18432,36864
71,Lebanon,2,2015,LEB-15/DDA-3604/Call for Proposals/H/NGO/1609,0,21,21,21,63,0,27,19,23,69
71,Lebanon,2,2015,LEB-15/DDA-3604/Call for Proposals/H/NGO/1617,5220,3780,250,250,9500,12696,15407,51,23,28177
71,Lebanon,2,2015,LEB-15/DDA-3604/Call for Proposals/SS-P/NGO/1624,10,40,0,20,70,13,42,0,20,75
71,Lebanon,2,2015,LEB-15/DDA-3604/Call for Proposals/P/INGO/1626,200,950,25,205,1380,107,1267,0,110,1484
71,Lebanon,2,2015,LEB-15/DDA-3604/Call for Proposals/P/INGO/1635,120,850,70,402,1442,132,1598,15,158,1903
71,Lebanon,2,2015,LEB-15/DDA-3604/Call for Proposals/P/UN/1637,1950,1708,0,0,3658,4625,3346,0,0,7971
71,Lebanon,2,2015,LEB-15/DDA-3604/Call for Proposals/P-H/NGO/1642,300,300,50,50,700,252,268,0,0,520
71,Lebanon,2,2015,LEB-15/DDA-3604/Call for Proposals/BA-LH-P/NGO/1643,0,1220,125,125,1470,156,1080,455,524,2215
71,Lebanon,2,2015,LEB-15/DDA-3604/Call for Proposals/P/NGO/1647,160,160,225,225,770,11,403,335,312,1061
71,Lebanon,2,2015,LEB-15/DDA-3604/Call for Proposals/P/NGO/1655,300,300,0,0,600,236,78,0,0,314
71,Lebanon,2,2015,LEB-15/DDA-3604/Call for Proposals/P/INGO/1657,3162,2566,0,0,5728,2393,3693,0,0,6086
71,Lebanon,2,2015,LEB-15/DDA-3604/Call for Proposals/P/INGO/1659,350,0,0,0,350,582,0,0,0,582
71,Lebanon,2,2015,LEB-15/DDA-3604/Call for Proposals/BA/INGO/1662,3142,3019,2516,2323,11000,4122,3838,3270,2985,14215
71,Lebanon,2,2016,LEB-16/DDA-3604/Call for proposals/BA/INGO/2351,522,572,720,686,2500,517,599,669,628,2413
71,Lebanon,2,2016,LEB-16/DDA-3604/Call for proposals/BA/INGO/2352,490,640,1026,1109,3265,490,640,1026,1109,3265
71,Lebanon,2,2016,LEB-16/DDA-3604/Call for proposals/FS/INGO/2353,340,1414,467,483,2704,736,2054,132,143,3065
71,Lebanon,2,2016,LEB-16/DDA-3604/Call for proposals/P/INGO/2362,50,1100,0,690,1840,50,1105,0,695,1850
71,Lebanon,2,2016,LEB-16/DDA-3604/Call for proposals/BA/NGO/2364,337,506,1348,2024,4215,751,101,0,0,852
71,Lebanon,2,2016,LEB-16/DDA-3604/Call for proposals/H/INGO/2380,81,49,9,15,154,91,86,16,7,200
71,Lebanon,2,2016,LEB-16/DDA-3604/Call for proposals/P/NGO/2389,425,305,0,0,730,655,591,0,1,1247
71,Lebanon,2,2016,LEB-16/DDA-3604/Call for proposals/FS-P/INGO/2395,1135,1165,1375,1375,5050,1094,1889,1436,1535,5954
71,Lebanon,2,2016,LEB-16/DDA-3604/Call for proposals/P/NGO/2436,0,0,60,60,120,0,0,141,79,220
71,Lebanon,2,2016,LEB-16/DDA-3604/Call for proposals/W-SS/NGO/2453,690,910,950,890,3440,690,910,950,890,3440
71,Lebanon,2,2016,LEB-16/DDA-3604/Call for proposals/BA/INGO/2480,687,807,850,781,3125,687,807,850,781,3125
71,Lebanon,2,2016,LEB-16/DDA-3604/Call for proposals/P/INGO/2488,146,860,125,250,1381,258,1120,12,271,1661
71,Lebanon,2,2016,LEB-16/DDA-3604/Call for proposals/BA/INGO/2493,1056,1035,544,533,3168,1056,1035,544,533,3168
71,Lebanon,2,2016,LEB-16/DDA-3604/Call for proposals/BA/INGO/2498,496,613,637,611,2357,432,582,491,524,2029
71,Lebanon,2,2016,LEB-16/DDA-3604/Call for proposals/LH/NGO/2502,70,80,0,0,150,35,20,0,0,55
71,Lebanon,2,2016,LEB-16/DDA-3604/Call for proposals/P/NGO/2504,0,100,35,0,135,0,108,38,54,200
71,Lebanon,1,2016,LEB-16/DDA-3604/Res16/P/INGO/2509,108,50,288,274,720,101,63,326,279,769
71,Lebanon,1,2016,LEB-16/DDA-3604/Res16/P/NGO/2511,75,75,325,325,800,0,0,0,0,0
71,Lebanon,1,2016,LEB-16/DDA-3604/Res16/W/NGO/2513,6915,11198,7169,11198,36480,0,0,0,0,0
71,Lebanon,1,2016,LEB-16/DDA-3604/Res16/FS/INGO/2514,1118,1082,0,0,2200,1144,635,182,239,2200
71,Lebanon,1,2016,LEB-16/DDA-3604/Res16/BA-LH/INGO/2518,1015,1015,4000,4000,10030,2018,2017,3450,3444,10929
71,Lebanon,1,2016,LEB-16/DDA-3604/Res16/P/INGO/2528,2300,7170,500,1100,11070,3356,7431,1472,1845,14104
71,Lebanon,1,2016,LEB-16/DDA-3604/Res16/P/INGO/2534,1000,750,1250,1500,4500,931,806,1325,1213,4275
71,Lebanon,1,2016,LEB-16/DDA-3604/Res16/W/INGO/2539,562,625,180,264,1631,358,388,414,448,1608
71,Lebanon,1,2016,LEB-16/DDA-3604/Res16/W/INGO/2545,1026,1265,1324,1265,4880,953,1145,1463,1506,5067
71,Lebanon,1,2016,LEB-16/DDA-3604/Res16/W/NGO/2547,3536,5307,6159,5625,20627,3361,5087,5770,5344,19562
71,Lebanon,1,2016,LEB-16/DDA-3604/Res16/W/INGO/3134,914,1387,1473,1436,5210,1811,2172,2302,2282,8567
71,Lebanon,2,2016,LEB-16/DDA-3604/Call for Proposals/SS/NGO/3180,87,58,48,32,225,68,53,80,120,321
71,Lebanon,1,2016,LEB-16/DDA-3604/Res16/S/NGO/3200,389,471,565,590,2015,482,488,503,550,2023
71,Lebanon,2,2016,LEB-16/DDA-3604/Call for Proposals/P-H/NGO/3222,0,100,50,60,210,0,407,24,36,467
71,Lebanon,2,2016,LEB-16/DDA-3604/Call for Proposals/P/INGO/3225,225,7862,450,2323,10860,331,15214,292,2716,18553
71,Lebanon,2,2016,LEB-16/DDA-3604/Call for Proposals/H/INGO/3226,8963,11097,11524,11097,42681,6442,14839,7789,7785,36855
71,Lebanon,2,2016,LEB-16/DDA-3604/Call for Proposals/SS/NGO/3230,60,30,155,130,375,39,45,251,347,682
71,Lebanon,2,2016,LEB-16/DDA-3604/Call for Proposals/W-H/INGO/3231,6500,28400,6550,11550,53000,6129,52351,11808,16377,86665
71,Lebanon,2,2016,LEB-16/DDA-3604/Call for Proposals/P/INGO/3239,405,417,425,598,1845,170,473,200,590,1433
71,Lebanon,2,2016,LEB-16/DDA-3604/Call for Proposals/W/UN/3249,14809,13809,1145,1145,30908,14809,13809,1145,1145,30908
71,Lebanon,2,2016,LEB-16/DDA-3604/Call for Proposals/SS/INGO/3250,2474,2474,1060,1060,7068,3213,3082,1323,1247,8865
71,Lebanon,2,2016,LEB-16/DDA-3604/Call for Proposals/W/INGO/3252,4056,4550,1873,2043,12522,4100,4610,1968,2133,12811
71,Lebanon,2,2016,LEB-16/DDA-3604/Call for Proposals/SS/NGO/3256,106,48,0,0,154,106,48,0,0,154
71,Lebanon,2,2016,LEB-16/DDA-3604/Call for Proposals/W/INGO/3258,3460,3581,5246,5413,17700,3334,3492,5142,5314,17282
71,Lebanon,2,2016,LEB-16/DDA-3604/Call for Proposals/P/NGO/3279,349,240,11,8,608,610,781,2,0,1393
71,Lebanon,2,2016,LEB-16/DDA-3604/Call for Proposals/H/INGO/3280,6647,14564,10622,10167,42000,4655,13735,10733,11025,40148
71,Lebanon,2,2016,LEB-16/DDA-3604/Call for Proposals/P/NGO/3287,25,25,108,82,240,19,40,120,76,255
71,Lebanon,2,2016,LEB-16/DDA-3604/Call for Proposals/P/UN/3288,15096,16399,13934,15071,60500,15410,16544,13917,15077,60948
71,Lebanon,2,2016,LEB-16/DDA-3604/Call for Proposals/P/INGO/3297,80,120,0,0,200,72,128,0,0,200
71,Lebanon,2,2016,LEB-16/DDA-3604/Call for Proposals/P/INGO/3311,250,655,0,660,1565,171,881,0,671,1723
71,Lebanon,2,2016,LEB-16/DDA-3604/Call for Proposals/P/INGO/3316,632,1988,640,5394,8654,691,2289,682,5237,8899
71,Lebanon,2,2016,LEB-16/DDA-3604/Call for Proposals/H/UN/3317,4400,6600,14000,14000,39000,2958,6956,32220,34943,77077
71,Lebanon,2,2016,LEB-16/DDA-3604/Call for Proposals/W/INGO/3325,21334,20088,31550,30133,103105,21334,20088,31550,30133,103105
71,Lebanon,2,2016,LEB-16/DDA-3604/Call for Proposals/S-W-SS/INGO/3333,1797,1832,1067,1090,5786,1728,1761,1026,1048,5563
71,Lebanon,2,2016,LEB-16/DDA-3604/Call for Proposals/W/INGO/3339,5980,5980,7020,7020,26000,14070,14070,16517,16517,61174
71,Lebanon,1,2016,LEB-16/DDA-3604/Res16/BA/INGO/4435,490,640,1026,1109,3265,490,640,1026,1109,3265
71,Lebanon,1,2016,LEB-16/DDA-3604/Res16/BA/INGO/4486,421,62,0,0,483,422,62,0,0,484
71,Lebanon,1,2016,LEB-16/DDA-3604/Res16/BA/INGO/4495,488,601,628,605,2322,432,582,491,524,2029
71,Lebanon,1,2016,LEB-16/DDA-3604/Res16/BA/INGO/4496,584,690,717,664,2655,584,690,717,664,2655
71,Lebanon,1,2017,LEB-17/DDA-3604/2017 RA_LEB/BA/INGO/5439,210,40,0,0,250,179,71,0,0,250
71,Lebanon,1,2017,LEB-17/DDA-3604/2017 RA_LEB/P/UN/5444,14976,16224,13824,14976,60000,10483,11357,9677,10483,42000
71,Lebanon,1,2017,LEB-17/DDA-3604/2017 RA_LEB/H/INGO/5485,17,12,0,0,29,0,14,0,0,14
71,Lebanon,1,2017,LEB-17/DDA-3604/2017 RA_LEB/P/NGO/5492,0,540,0,0,540,0,208,1,1,210
71,Lebanon,1,2017,LEB-17/DDA-3604/2017 RA_LEB/BA/INGO/5521,490,640,1026,1109,3265,490,640,1026,1109,3265
71,Lebanon,1,2017,LEB-17/DDA-3604/2017 RA_LEB/H/NGO/5547,73,49,0,0,122,68,54,0,0,122
71,Lebanon,1,2017,LEB-17/DDA-3604/2017 RA_LEB/P/NGO/5563,0,300,0,100,400,0,113,0,39,152
71,Lebanon,1,2017,LEB-17/DDA-3604/2017 RA_LEB/H/INGO/5594,18,11,3,0,32,17,10,3,0,30
71,Lebanon,2,2017,LEB-17/DDA-3604/20171stSA/H/NGO/6301,0,0,220,80,300,0,0,118,23,141
71,Lebanon,2,2017,LEB-17/DDA-3604/20171stSA/P/NGO/6310,0,0,50,50,100,0,0,54,46,100
71,Lebanon,2,2017,LEB-17/DDA-3604/20171stSA/H/INGO/6317,204,292,24,55,575,216,265,67,57,605
71,Lebanon,2,2017,LEB-17/DDA-3604/20171stSA/P/INGO/6319,250,595,0,370,1215,135,707,0,347,1189
71,Lebanon,2,2017,LEB-17/DDA-3604/20171stSA/E/NGO/6332,0,0,100,150,250,0,0,112,101,213
71,Lebanon,2,2017,LEB-17/DDA-3604/20171stSA/P-S/INGO/6333,1187,1137,590,561,3475,61,56,35,18,170
71,Lebanon,2,2017,LEB-17/DDA-3604/20171stSA/E/INGO/6341,180,180,165,166,691,0,0,83,50,133
71,Lebanon,2,2017,LEB-17/DDA-3604/20171stSA/H/NGO/6342,2500,2500,0,0,5000,6068,8183,0,0,14251
71,Lebanon,2,2017,LEB-17/DDA-3604/20171stSA/P/NGO/6346,750,840,85,125,1800,296,826,46,65,1233
71,Lebanon,2,2017,LEB-17/DDA-3604/20171stSA/W/NGO/6348,750,750,250,250,2000,750,750,250,250,2000
71,Lebanon,2,2017,LEB-17/DDA-3604/20171stSA/S/INGO/6354,67,75,80,82,304,6,48,32,28,114
71,Lebanon,2,2017,LEB-17/DDA-3604/20171stSA/S-W/INGO/6359,1814,2839,3109,3033,10795,2468,2989,3232,3209,11898
71,Lebanon,2,2017,LEB-17/DDA-3604/20171stSA/P-S/INGO/6363,705,825,299,300,2129,42,127,0,0,169
71,Lebanon,2,2017,LEB-17/DDA-3604/20171stSA/SS/NGO/6371,60,60,0,0,120,60,60,0,0,120
71,Lebanon,2,2017,LEB-17/DDA-3604/20171stSA/P/NGO/6385,1188,1452,0,0,2640,401,490,0,0,891
71,Lebanon,1,2017,LEB-17/DDA-3604/LBN-17-2ND-RES/P/NGO/7386,0,0,96,96,192,0,0,129,90,219
71,Lebanon,1,2017,LEB-17/DDA-3604/LBN-17-2ND-RES/P/INGO/7623,278,802,591,533,2204,40,958,662,663,2323
71,Lebanon,1,2017,LEB-17/DDA-3604/LBN-17-2ND-RES/P/INGO/7648,0,30,0,15,45,2,13,4,9,28
59,Myanmar,2,2015,MM-15/DDA-3415/RK-ER/H/NGO/1149,17561,19349,0,0,36910,16041,17284,2792,3134,39251
59,Myanmar,1,2015,MM-15/DDA-3415/R/SNFI/NGO/1150,138,142,203,214,697,157,150,221,237,765
59,Myanmar,2,2015,MM-15/DDA-3415/RK-ER/E/INGO/1181,300,300,630,630,1860,1013,808,522,713,3056
59,Myanmar,2,2015,MM-15/DDA-3415/RK-ER/WASH-FS/INGO/1422,4197,10778,3080,3330,21385,5794,6711,4629,4546,21680
59,Myanmar,1,2015,MM-15/DDA-3415/R/SNFI/INGO/1752,4783,5120,3797,3766,17466,4845,5389,3849,3599,17682
59,Myanmar,1,2015,MM-15/DDA-3415/R/WASH-SNFI/INGO/1754,4200,4856,1969,2100,13125,7115,8389,3463,3562,22529
59,Myanmar,1,2015,MM-15/DDA-3415/R/FS-WASH/INGO/1755,20446,20438,0,0,40884,20279,20260,0,0,40539
59,Myanmar,1,2015,MM-15/DDA-3415/R/FS/INGO/1765,3626,4088,2234,3352,13300,3510,5656,0,0,9166
59,Myanmar,1,2015,MM-15/DDA-3415/R/WASH-FS/INGO/1767,2296,2637,1494,1448,7875,4130,4283,1989,2331,12733
59,Myanmar,1,2015,MM-15/DDA-3415/R/WASH/NGO/1769,2552,3185,1236,1452,8425,2552,3185,1236,1452,8425
59,Myanmar,2,2015,MM-15/DDA-3415/SA/E/INGO/1789,163,271,2995,2768,6197,57,270,2907,2679,5913
59,Myanmar,1,2015,MM-15/DDA-3415/R/FS/NGO/1792,1219,2897,2556,3128,9800,1821,2905,2564,3136,10426
59,Myanmar,2,2015,MM-15/DDA-3415/SA/P/INGO/1796,3600,3600,3600,3600,14400,5674,5627,2894,3247,17442
59,Myanmar,2,2015,MM-15/DDA-3415/SA/N/INGO/1873,0,0,960,1040,2000,0,0,1156,1605,2761
59,Myanmar,2,2015,MM-15/DDA-3415/SA/E/INGO/1902,129,129,3880,3880,8018,232,130,4269,3745,8376
59,Myanmar,2,2015,MM-15/DDA-3415/SA/H/INGO/1933,1808,2589,701,711,5809,276,1095,28,105,1504
59,Myanmar,2,2015,MM-15/DDA-3415/SA/WASH/INGO/1934,1162,1446,1803,1670,6081,1350,1721,1721,1499,6291
59,Myanmar,2,2015,MM-15/DDA-3415/SA/WASH-SNFI/INGO/1935,1140,1260,300,300,3000,1932,2442,1843,1861,8078
59,Myanmar,2,2015,MM-15/DDA-3415/SA/H-WASH/INGO/1936,3554,3966,578,647,8745,3554,3966,578,647,8745
59,Myanmar,2,2015,MM-15/DDA-3415/SA/N/INGO/1937,106,3661,29,29,3825,0,0,0,0,0
59,Myanmar,2,2015,MM-15/DDA-3415/SA/H/NGO/1940,6584,8047,10243,11705,36579,7731,11820,5930,6155,31636
59,Myanmar,2,2015,MM-15/DDA-3415/SA/H/NGO/1950,0,2277,4228,4482,10987,0,3477,4027,3594,11098
59,Myanmar,1,2015,MM-15/DDA-3415/R/WASH-H-P/INGO/2045,3271,3398,344,693,7706,1145,2129,1893,2129,7296
59,Myanmar,1,2016,MM-16/DDA-3415/MM-16/DDA-3415/R/SNFI/UN/3120,4000,5000,5700,5300,20000,4349,5405,6520,6016,22290
59,Myanmar,1,2016,MM-16/DDA-3415/MM-16/DDA-3415/R/WASH/INGO/3136,688,906,89,102,1785,681,863,87,97,1728
59,Myanmar,1,2016,MM-16/DDA-3415/MM-16/DDA-3415/R/WASH/INGO/3138,766,869,1096,1256,3987,766,869,1096,1256,3987
59,Myanmar,1,2016,MM-16/DDA-3415/MM-16/DDA-3415/E/INGO/3937,615,314,4494,4293,9716,428,186,3115,3010,6739
59,Myanmar,1,2016,MM-16/DDA-3415/MM-16/DDA-3415/P/INGO/4007,4000,3400,2800,2000,12200,2376,2559,2902,3472,11309
59,Myanmar,1,2016,MM-16/DDA-3415/MM-16/DDA-3415/H/NGO/4024,0,1941,4234,4488,10663,0,1822,4150,3773,9745
59,Myanmar,1,2016,MM-16/DDA-3415/MM-16/DDA-3415/P/INGO/4025,4320,4320,4320,4320,17280,7718,9671,4180,4620,26189
59,Myanmar,1,2016,MM-16/DDA-3415/MM-16/DDA-3415/SNFI/NGO/4026,931,1062,640,757,3390,855,873,877,868,3473
59,Myanmar,1,2016,MM-16/DDA-3415/MM-16/DDA-3415/H/NGO/4027,2633,3017,2642,2748,11040,2331,2664,2391,1728,9114
59,Myanmar,1,2016,MM-16/DDA-3415/MM-16/DDA-3415/P/INGO/4050,878,1164,1084,1174,4300,1257,1616,1201,1236,5310
59,Myanmar,1,2016,MM-16/DDA-3415/MM-16/DDA-3415/WASH-SNFI/INGO/4078,1840,1600,430,430,4300,3714,3643,1719,1781,10857
59,Myanmar,1,2016,MM-16/DDA-3415/MM-16/DDA-3415/H/INGO/4157,5292,7938,2268,3402,18900,1043,2554,754,863,5214
59,Myanmar,1,2016,MM-16/DDA-3415/MM-16/DDA-3415/FS-SNFI-WASH-N/NGO/4172,4860,6584,4643,5183,21270,4698,5389,1430,1488,13005
59,Myanmar,1,2016,MM-16/DDA-3415/MM-16/DDA-3415/P-E/NGO/4190,249,385,152,249,1035,250,385,150,250,1035
59,Myanmar,1,2016,MM-16/DDA-3415/MM-16/DDA-3415/E/INGO/4191,1515,1515,3275,3275,9580,1434,1626,5870,6028,14958
59,Myanmar,1,2016,MM-16/DDA-3415/MM-16/DDA-3415/H/INGO/4214,4625,4112,822,719,10278,4716,4193,838,733,10480
59,Myanmar,1,2016,MM-16/DDA-3415/MM-16/DDA-3415/E/NGO/4246,870,787,425,508,2590,870,787,425,508,2590
59,Myanmar,1,2016,MM-16/DDA-3415/MM-16/DDA-3415/SNFI/NGO/4247,305,714,248,684,1951,305,714,248,684,1951
59,Myanmar,1,2016,MM-16/DDA-3415/MM-16/DDA-3415/P/INGO/4313,180,240,180,240,840,142,240,190,224,796
59,Myanmar,1,2016,MM-16/DDA-3415/MM-16/DDA-3415/FS/NGO/4319,1940,2929,1992,2072,8933,1894,2090,1906,2100,7990
59,Myanmar,1,2016,MM-16/DDA-3415/MM-16/DDA-3415/SNFI/NGO/4320,835,1082,851,819,3587,117,167,142,158,584
59,Myanmar,1,2016,MM-16/DDA-3415/RA/FS/NGO/4509,1781,2253,1728,1701,7463,1835,2285,1736,1698,7554
59,Myanmar,1,2017,MM-17/DDA-3415/01-RA/E/INGO/4977,2046,1589,5781,5375,14791,3401,1866,5536,4830,15633
59,Myanmar,1,2017,MM-17/DDA-3415/01-RA/N-WASH/INGO/5007,2021,4401,2737,4416,13575,2021,4111,2415,4095,12642
59,Myanmar,1,2017,MM-17/DDA-3415/01-RA/P/INGO/5153,366,549,476,439,1830,448,823,697,683,2651
59,Myanmar,1,2017,MM-17/DDA-3415/01-RA/WASH-P-E/INGO/5161,1766,2126,1619,1608,7119,1869,2147,1756,1593,7365
59,Myanmar,1,2017,MM-17/DDA-3415/01-RA/SNFI/NGO/5165,456,573,418,422,1869,462,589,428,436,1915
59,Myanmar,1,2017,MM-17/DDA-3415/01-RA/SNFI/NGO/5171,419,411,293,246,1369,165,179,145,137,626
59,Myanmar,1,2017,MM-17/DDA-3415/RA-02/E/INGO/6407,78,105,5177,4258,9618,105,78,4895,3990,9068
59,Myanmar,1,2017,MM-17/DDA-3415/RA-02/WASH/INGO/6435,4143,4970,5557,5588,20258,4124,5214,5473,5447,20258
59,Myanmar,2,2017,MM-17/DDA-3415/01-SA/P-WASH-FS/INGO/6805,4719,6265,5682,5883,22549,1851,2515,2005,2012,8383
59,Myanmar,2,2017,MM-17/DDA-3415/01-SA/H/UN/6815,20520,22231,12577,13625,68953,15405,16690,9442,10229,51766
59,Myanmar,2,2017,MM-17/DDA-3415/01-SA/WASH-SNFI/INGO/6839,1682,2056,1006,1006,5750,691,785,758,722,2956
59,Myanmar,2,2017,MM-17/DDA-3415/01-SA/SNFI/NGO/6840,117,168,153,168,606,193,234,168,155,750
59,Myanmar,2,2017,MM-17/DDA-3415/01-SA/P-SNFI/INGO/6842,3375,3526,1570,1608,10079,1189,1619,208,311,3327
59,Myanmar,2,2017,MM-17/DDA-3415/01-SA/E-H-SNFI-WASH-FS/NGO/6843,7554,9389,8611,8633,34187,1317,2305,3850,3909,11381
59,Myanmar,2,2017,MM-17/DDA-3415/01-SA/FS-SNFI-WASH-N/NGO/6845,1868,3117,2313,2450,9748,1301,2852,1361,1874,7388
59,Myanmar,2,2017,MM-17/DDA-3415/01-SA/P/INGO/6847,6038,6038,6032,6032,24140,11380,12718,6305,7935,38338
59,Myanmar,2,2017,MM-17/DDA-3415/01-SA/N/INGO/6853,1358,1452,485,427,3722,39,837,95,156,1127
59,Myanmar,2,2017,MM-17/DDA-3415/02-SA/P-WASH/INGO/7086,11358,12285,11920,11531,47094,920,1418,4503,4524,11365
59,Myanmar,2,2017,MM-17/DDA-3415/02-SA/E/NGO/7180,1331,1104,666,988,4089,1331,1104,666,988,4089
59,Myanmar,2,2017,MM-17/DDA-3415/02-SA/E/INGO/7310,315,315,392,758,1780,0,0,0,0,0
59,Myanmar,2,2017,MM-17/DDA-3415/02-SA/FS/UN/7315,4974,5880,1183,1061,13098,3648,4406,2353,2319,12726
59,Myanmar,2,2017,MM-17/DDA-3415/02-SA/P-H/INGO/7320,5767,14030,18508,19709,58014,12096,25230,7435,13538,58299
59,Myanmar,2,2017,MM-17/DDA-3415/02-SA/FS/INGO/7321,2426,3106,2077,2096,9705,673,673,916,952,3214
59,Myanmar,2,2017,MM-17/DDA-3415/02-SA/H-P/INGO/7323,4465,5098,4839,4665,19067,4465,5089,4839,4662,19055
59,Myanmar,2,2017,MM-17/DDA-3415/02-SA/H/UN/7326,10210,13783,6497,8771,39261,3328,24976,25,30,28359
75,Nigeria,2,2017,NGA-17/NIG_ERF/SA/S/NFI/INGO/6376,4212,4447,6552,8189,23400,3462,4345,5822,5956,19585
75,Nigeria,2,2017,NGA-17/NIG_ERF/SA/LOG/UN/6403,160,190,0,0,350,290,0,0,0,290
75,Nigeria,2,2017,NGA-17/NIG_ERF/SA/LOG/UN/6405,5,0,0,0,5,5,0,0,0,5
75,Nigeria,2,2017,NGA-17/NIG_ERF/SA/S/NFI/INGO/6406,3818,3670,3526,3386,14400,2634,3144,4482,4694,14954
75,Nigeria,2,2017,NGA-17/NIG_ERF/SA/H/NGO/6408,0,10500,0,10500,21000,3732,25962,2345,17090,49129
75,Nigeria,2,2017,NGA-17/NIG_ERF/SA/H/UN/6411,0,0,558026,558026,1116052,0,0,629221,599257,1228478
75,Nigeria,2,2017,NGA-17/NIG_ERF/SA/P/UN/6419,900,1700,2500,3000,8100,150,300,250,500,1200
75,Nigeria,2,2017,NGA-17/NIG_ERF/SA/WASH/INGO/6420,2320,4060,2320,5800,14500,3343,6588,3021,7714,20666
75,Nigeria,2,2017,NGA-17/NIG_ERF/SA/H/UN/6422,16450,35626,18650,23450,94176,7000,85012,12242,45241,149495
75,Nigeria,2,2017,NGA-17/NIG_ERF/SA/P/UN/6423,4106,44347,32850,82120,163423,3910,37195,29892,74104,145101
75,Nigeria,2,2017,NGA-17/NIG_ERF/SA/S/NFI/UN/6427,12450,14765,15925,19860,63000,17752,18962,15144,16662,68520
75,Nigeria,2,2017,NGA-17/NIG_ERF/SA/WASH/UN/6429,34520,39450,41100,49300,164370,38370,43850,45670,54814,182704
75,Nigeria,2,2017,NGA-17/NIG_ERF/SA2/N/UN/6888,0,0,2066,1985,4051,0,0,71,68,139
75,Nigeria,2,2017,NGA-17/NIG_ERF/SA2/RR/UN/6905,2892,3517,2580,4011,13000,3348,4072,2987,4644,15051
75,Nigeria,2,2017,NGA-17/NIG_ERF/SA2/DMS-S/NFI/INGO/6907,7326,8264,8816,10594,35000,5398,6012,11644,11131,34185
75,Nigeria,2,2017,NGA-17/NIG_ERF/SA2/WASH/UN/6910,25880,30370,31620,37130,125000,43060,50550,62530,73410,229550
75,Nigeria,2,2017,NGA-17/NIG_ERF/SA2/E/UN/6925,252,252,12600,12600,25704,104,22,7237,6953,14316
75,Nigeria,2,2017,NGA-17/NIG_ERF/SA2/WASH/INGO/7090,7851,9134,10553,12462,40000,12352,14204,16003,19084,61643
75,Nigeria,2,2017,NGA-17/NIG_ERF/SA2/P/NGO/7140,234,576,1368,2052,4230,88,122,125,104,439
75,Nigeria,2,2017,NGA-17/NIG_ERF/SA2/E/NGO/7148,60,20,2764,4207,7051,60,20,2764,4207,7051
75,Nigeria,2,2017,NGA-17/NIG_ERF/SA2/P/NGO/7157,4060,7450,2150,3564,17224,8054,9575,4105,5257,26991
75,Nigeria,2,2017,NGA-17/NIG_ERF/SA2/H/UN/7211,2032,2217,2032,2956,9237,2336,2812,480,454,6082
75,Nigeria,2,2017,NGA-17/NIG_ERF/SA2/H/UN/7243,12968,75071,43182,52779,184000,17646,27850,22487,23404,91387
75,Nigeria,2,2017,NGA-17/NIG_ERF/SA2/S/NFI/INGO/7249,2512,2833,3023,3632,12000,2151,2611,3250,3077,11089
75,Nigeria,2,2017,NGA-17/NIG_ERF/SA2/S/NFI/NGO/7270,1000,2500,1000,2500,7000,1000,2589,1130,2793,7512
75,Nigeria,2,2017,NGA-17/NIG_ERF/SA2/N/UN/7277,0,47064,60006,57653,164723,0,23187,102052,98050,223289
75,Nigeria,2,2017,NGA-17/NIG_ERF/SA2/P/INGO/7278,20000,15000,10000,10000,55000,7546,8060,2356,2356,20318
75,Nigeria,2,2017,NGA-17/NIG_ERF/SA2/P/INGO/7281,128,488,9000,9000,18616,6,14,122,230,372
75,Nigeria,2,2017,NGA-17/NIG_ERF/SA2/WASH/INGO/7284,1636,1818,2732,2514,8700,0,0,0,0,0
75,Nigeria,2,2017,NGA-17/NIG_ERF/SA2/E/INGO/7297,360,475,6125,6125,13085,0,0,0,0,0
75,Nigeria,2,2017,NGA-17/NIG_ERF/SA2/S/NFI-DMS/INGO/7304,1087,1136,1284,1433,4940,182,195,115,150,642
75,Nigeria,2,2017,NGA-17/NIG_ERF/SA2/P/INGO/7306,822,3662,979,4327,9790,1314,5660,640,2296,9910
75,Nigeria,2,2017,NGA-17/NIG_ERF/SA2/E/NGO/7307,50,50,1800,2200,4100,68,32,2166,1834,4100
75,Nigeria,2,2017,NGA-17/NIG_ERF/SA2/DMS/UN/7314,20217,37276,27152,44932,129577,7809,11379,12265,16601,48054
75,Nigeria,1,2018,NGA-18/NIG_ERF/RA1/N/INGO/8143,0,5424,13718,12139,31281,0,808,10488,8782,20078
75,Nigeria,1,2018,NGA-18/NIG_ERF/RA1/S/NFI/INGO/8150,1847,1902,2720,2830,9299,1046,1093,1771,1493,5403
75,Nigeria,1,2018,NGA-18/NIG_ERF/RA1/H/INGO/8161,933,1498,3993,3676,10100,869,1846,2509,2053,7277
75,Nigeria,1,2018,NGA-18/NIG_ERF/RA1/WASH/UN/8175,2197,2935,4768,5877,15777,4858,5702,6182,7258,24000
75,Nigeria,1,2018,NGA-18/NIG_ERF/RA1/DMS-S/NFI/UN/8233,4920,5389,7178,5943,23430,5629,6104,7470,7830,27033
75,Nigeria,1,2018,NGA-18/NIG_ERF/RA1/S/NFI-DMS/INGO/8244,5250,5750,6250,7750,25000,4506,4990,3996,4200,17692
75,Nigeria,1,2018,NGA-18/NIG_ERF/RA1/N-H-WASH/INGO/8279,5796,18372,6236,7257,37661,952,1717,3562,4072,10303
75,Nigeria,1,2018,NGA-18/NIG_ERF/RA1/P/UN/8296,3591,3064,5261,4087,16003,2668,3335,3526,4272,13801
75,Nigeria,1,2018,NGA-18/NIG_ERF/RA1/S/NFI/UN/8307,1221,1243,1443,1693,5600,475,405,515,605,2000
75,Nigeria,1,2018,NGA-18/NIG_ERF/RA1/WASH/INGO/8642,2355,2740,3165,3740,12000,1493,1011,1111,1397,5012
75,Nigeria,1,2018,NGA-18/NIG_ERF/RA1/WASH/UN/8652,2197,2935,4768,5877,15777,67,109,2631,3358,6165
75,Nigeria,1,2018,NGA-18/NIG_ERF/RA1/P/UN/8716,1569,2320,1706,2115,7710,1569,2320,1706,2115,7710
75,Nigeria,1,2018,NGA-18/NIG_ERF/RA1/P/UN/8768,1300,2190,3050,3460,10000,1706,2790,3259,3760,11515
75,Nigeria,1,2018,NGA-18/NIG_ERF/RA2/WASH/INGO/9211,12461,14175,19833,12995,59464,7211,8715,14583,7955,38464
75,Nigeria,1,2018,NGA-18/NIG_ERF/RA3/WASH/UN/9440,24320,36911,22602,29780,113613,23221,36911,22602,27546,110280
67,oPt,1,2015,OPT-15/DDA-3482/R/SNFI/INGO/1137,91,72,95,88,346,93,74,100,90,357
67,oPt,1,2015,OPT-15/DDA-3482/R/SNFI/INGO/1148,67,85,53,51,256,70,68,30,54,222
67,oPt,1,2015,OPT-15/DDA-3482/R/FSL/NGO/1265,509,22,893,859,2283,435,20,835,803,2093
67,oPt,1,2015,OPT-15/DDA-3482/R/FSL/NGO/1273,332,10,1026,1020,2388,332,10,1026,1030,2398
67,oPt,2,2015,OPT-15/DDA-3482/oPt/SNFI/INGO/1547,61,68,272,272,673,65,69,156,161,451
67,oPt,2,2015,OPT-15/DDA-3482/oPt/FSL/INGO/1549,183,177,403,389,1152,353,355,406,381,1495
67,oPt,2,2015,OPT-15/DDA-3482/oPt/PROT/NGO/1553,0,19250,0,0,19250,0,9305,0,0,9305
67,oPt,2,2015,OPT-15/DDA-3482/oPt/FSL/NGO/1559,55,55,0,0,110,55,55,376,361,847
67,oPt,2,2015,OPT-15/DDA-3482/oPt/PROT/INGO/1570,300,540,1344,1344,3528,271,1023,2932,3337,7563
67,oPt,2,2015,OPT-15/DDA-3482/oPt/EDU/INGO/1585,54,167,1205,1101,2527,20,99,1381,1584,3084
67,oPt,2,2015,OPT-15/DDA-3482/oPt/WASH/INGO/1595,5954,6588,6302,6112,24956,6156,6736,6242,6195,25329
67,oPt,2,2015,OPT-15/DDA-3482/oPt/HNC/INGO/1628,1400,3000,2000,3600,10000,2829,8208,2639,2803,16479
67,oPt,2,2015,OPT-15/DDA-3482/oPt/EDU/INGO/1664,0,0,3997,3987,7984,0,0,3997,3987,7984
67,oPt,2,2015,OPT-15/DDA-3482/oPt/HNC/NGO/1668,2700,3300,750,750,7500,3600,4542,1036,1000,10178
67,oPt,2,2015,OPT-15/DDA-3482/oPt/WASH/INGO/1680,710,740,785,785,3020,713,736,801,792,3042
67,oPt,1,2015,OPT-15/DDA-3482/R/WASH/INGO/1701,275,300,254,242,1071,275,300,254,242,1071
67,oPt,1,2015,OPT-15/DDA-3482/R/FSL/UN/1835,2600,2600,4940,4940,15080,2600,2600,4940,4940,15080
67,oPt,1,2015,OPT-15/DDA-3482/R/PROT/INGO/2094,169,73,0,0,242,419,230,0,0,649
67,oPt,2,2015,OPT-15/DDA-3482/oPt/WASH/INGO/2113,6004,6249,5768,6004,24025,6568,6599,5381,5659,24207
67,oPt,2,2015,OPT-15/DDA-3482/oPt/FSL/INGO/2124,803,803,589,589,2784,1069,1088,817,725,3699
67,oPt,2,2015,OPT-15/DDA-3482/oPt/FSL/INGO/2130,744,750,1420,1420,4334,832,800,1560,1558,4750
67,oPt,2,2015,OPT-15/DDA-3482/oPt/FSL/NGO/2138,572,858,468,702,2600,958,1438,784,1177,4357
67,oPt,2,2015,OPT-15/DDA-3482/oPt/WASH/INGO/2140,10185,9815,15000,15000,50000,10185,9815,15000,15000,50000
67,oPt,2,2015,OPT-15/DDA-3482/oPt/SNFI/INGO/2157,570,549,839,838,2796,733,750,666,627,2776
67,oPt,2,2015,OPT-15/DDA-3482/oPt/SNFI/INGO/2224,3,50,180,167,400,3,47,178,160,388
67,oPt,2,2015,OPT-15/DDA-3482/oPt/SNFI/NGO/2240,40,39,30,42,151,40,39,30,42,151
67,oPt,2,2015,OPT-15/DDA-3482/oPt/SNFI/INGO/2241,374,361,325,319,1379,399,418,363,353,1533
67,oPt,2,2015,OPT-15/DDA-3482/oPt/SNFI/INGO/2262,147,149,159,154,609,149,151,161,157,618
67,oPt,2,2015,OPT-15/DDA-3482/oPt/SNFI/INGO/2273,12,12,13,13,50,29,21,16,15,81
67,oPt,1,2016,OPT-16/DDA-3482/R/PROT/NGO/2336,150,200,550,500,1400,349,351,718,1467,2885
67,oPt,1,2016,OPT-16/DDA-3482/R/FSL/UN/2339,7683,7904,7020,7393,30000,10969,9441,8026,6302,34738
67,oPt,2,2016,OPT-16/DDA-3482/oPt/SNFI/INGO/2966,1467,1328,631,706,4132,902,973,1377,1241,4493
67,oPt,2,2016,OPT-16/DDA-3482/oPt/WASH/INGO/2976,1029,1176,1264,1235,4704,1029,1176,1264,1235,4704
67,oPt,2,2016,OPT-16/DDA-3482/oPt/PROT/INGO/2984,51650,53350,36890,38110,180000,51650,53350,36890,38110,180000
67,oPt,2,2016,OPT-16/DDA-3482/oPt/SNFI/NGO/2991,111,137,106,136,490,111,137,106,136,490
67,oPt,2,2016,OPT-16/DDA-3482/oPt/HNC/INGO/2998,1400,3000,2000,3600,10000,1942,3440,1876,2892,10150
67,oPt,2,2016,OPT-16/DDA-3482/oPt/PROT/UN/3008,890,1728,1940,1940,6498,752,1600,2392,2378,7122
67,oPt,2,2016,OPT-16/DDA-3482/oPt/FSL/INGO/3029,1043,1043,1422,1422,4930,1459,1481,1240,1193,5373
67,oPt,2,2016,OPT-16/DDA-3482/oPt/SNFI/INGO/3032,195,186,152,145,678,218,201,152,187,758
67,oPt,2,2016,OPT-16/DDA-3482/oPt/FSL/NGO/3053,640,644,1081,1041,3406,769,769,1206,1255,3999
67,oPt,2,2016,OPT-16/DDA-3482/oPt/PROT/NGO/3055,250,820,30,70,1170,96,1056,12,72,1236
67,oPt,2,2016,OPT-16/DDA-3482/oPt/PROT/INGO/3118,616,920,942,942,3420,647,1068,986,992,3693
67,oPt,2,2016,OPT-16/DDA-3482/oPt/FSL/INGO/3119,402,313,1795,1783,4293,700,514,2126,1828,5168
67,oPt,2,2016,OPT-16/DDA-3482/oPt/SNFI/INGO/3121,86,83,116,112,397,94,91,111,108,404
67,oPt,2,2016,OPT-16/DDA-3482/oPt/PROT/INGO/3125,230,1030,120,300,1680,204,1382,153,226,1965
67,oPt,2,2016,OPT-16/DDA-3482/oPt/FSL/INGO/3127,556,70,0,0,626,1696,1490,830,728,4744
67,oPt,2,2016,OPT-16/DDA-3482/oPt/FSL/INGO/3128,694,665,327,314,2000,694,665,327,314,2000
67,oPt,2,2016,OPT-16/DDA-3482/oPt/SNFI/INGO/3129,408,392,563,542,1905,408,392,563,542,1905
67,oPt,1,2016,OPT-16/DDA-3482/R/WASH/UN/3146,4676,3459,6322,6240,20697,4747,3540,5958,6967,21212
67,oPt,1,2016,OPT-16/DDA-3482/R/WASH/UN/4351,18400,19100,19500,18000,75000,18400,19100,19500,18000,75000
67,oPt,2,2016,OPT-16/DDA-3482/oPt/WASH/UN/4396,24534,23490,28710,27666,104400,24534,23490,28710,27666,104400
67,oPt,2,2016,OPT-16/DDA-3482/oPt/SNFI/INGO/4398,742,875,743,830,3190,1335,1630,1384,1546,5895
67,oPt,2,2016,OPT-16/DDA-3482/oPt/SNFI/INGO/4399,156,145,141,143,585,209,167,204,169,749
67,oPt,2,2016,OPT-16/DDA-3482/oPt/SNFI/NGO/4410,188,192,131,139,650,125,144,217,220,706
67,oPt,2,2016,OPT-16/DDA-3482/oPt/SNFI/UN/4420,314,34,348,348,1044,459,483,477,453,1872
67,oPt,2,2016,OPT-16/DDA-3482/oPt/WASH/INGO/4423,2743,2426,5230,4455,14854,2743,2426,5230,4455,14854
67,oPt,2,2016,OPT-16/DDA-3482/oPt/WASH/INGO/4424,15141,14547,11422,10974,52084,15141,14547,11422,10974,52084
67,oPt,2,2016,OPT-16/DDA-3482/oPt/SNFI/UN/4426,1242,1194,0,0,2436,0,0,0,0,0
67,oPt,1,2017,OPT-17/DDA-3482/oPt/FSL/UN/5556,1414,1519,2178,2033,7144,1608,1775,2415,2299,8097
67,oPt,1,2017,OPT-17/DDA-3482/oPt/HNC/UN/5614,975256,937011,0,0,1912267,975256,937011,0,0,1912267
67,oPt,2,2017,OPT-17/DDA-3482/OPT/FSL/NGO/5835,498,498,781,813,2590,531,563,866,856,2816
67,oPt,2,2017,OPT-17/DDA-3482/OPT/FSL/NGO/5836,60,60,0,0,120,50,50,0,0,100
67,oPt,2,2017,OPT-17/DDA-3482/OPT/PROT/INGO/5847,232,10300,218,228,10978,284,10604,234,431,11553
67,oPt,2,2017,OPT-17/DDA-3482/OPT/HNC/INGO/5855,86,114,900,900,2000,160,138,1829,1758,3885
67,oPt,2,2017,OPT-17/DDA-3482/OPT/PROT/NGO/5859,267,1423,240,510,2440,314,1862,293,663,3132
67,oPt,2,2017,OPT-17/DDA-3482/OPT/WASH/NGO/5864,430,412,189,190,1221,370,354,163,163,1050
67,oPt,2,2017,OPT-17/DDA-3482/OPT/FSL/NGO/5866,122,56,0,0,178,147,57,0,0,204
67,oPt,2,2017,OPT-17/DDA-3482/OPT/SNFI/INGO/5872,56,54,60,58,228,62,56,109,91,318
67,oPt,2,2017,OPT-17/DDA-3482/OPT/PROT/NGO/5875,230,2510,60,1310,4110,230,2512,61,1314,4117
67,oPt,2,2017,OPT-17/DDA-3482/OPT/SNFI/INGO/5876,147,142,119,115,523,134,131,110,106,481
67,oPt,2,2017,OPT-17/DDA-3482/OPT/EDU/INGO/5878,25,30,521,420,996,93,37,536,473,1139
67,oPt,2,2017,OPT-17/DDA-3482/OPT/EDU/INGO/5881,0,0,500,500,1000,0,0,430,437,867
67,oPt,2,2017,OPT-17/DDA-3482/OPT/HNC/NGO/5888,40,111100,0,31000,142140,40,111383,0,31000,142423
67,oPt,2,2017,OPT-17/DDA-3482/OPT/PROT/INGO/5895,80,80,160,160,480,30,30,90,90,240
67,oPt,2,2017,OPT-17/DDA-3482/OPT/HNC/UN/5896,3142,2571,1347,1102,8162,3719,3089,1422,1081,9311
67,oPt,2,2017,OPT-17/DDA-3482/OPT/FSL/INGO/5901,602,534,296,263,1695,513,361,438,407,1719
67,oPt,2,2017,OPT-17/DDA-3482/OPT/HNC/INGO/5903,1400,3000,2000,3600,10000,2376,9056,2394,2661,16487
67,oPt,2,2017,OPT-17/DDA-3482/OPT/PROT/NGO/5915,270,196,160,188,814,270,196,160,188,814
67,oPt,2,2017,OPT-17/DDA-3482/OPT/FSL/NGO/5919,321,321,620,600,1862,346,347,651,628,1972
67,oPt,2,2017,OPT-17/DDA-3482/OPT/HNC/INGO/5930,130,110,90,70,400,129,119,116,112,476
67,oPt,2,2017,OPT-17/DDA-3482/OPT/PROT/NGO/5932,197,328,72,103,700,215,269,144,80,708
67,oPt,2,2017,OPT-17/DDA-3482/OPT/PROT/INGO/5939,8,60,505,355,928,8,87,531,308,934
67,oPt,2,2017,OPT-17/DDA-3482/OPT/WASH/NGO/5941,310400,300802,289985,282148,1183335,310400,300802,289985,282148,1183335
67,oPt,2,2017,OPT-17/DDA-3482/OPT/WASH/UN/5947,4500,4277,6150,7216,22143,4515,4290,6169,6951,21925
67,oPt,2,2017,OPT-17/DDA-3482/OPT/SNFI/INGO/5966,227,277,228,236,968,304,320,225,247,1096
67,oPt,2,2017,OPT-17/DDA-3482/OPT/HNC/NGO/5969,842,1963,1012,433,4250,1616,2142,833,628,5219
67,oPt,2,2017,OPT-17/DDA-3482/OPT/PROT/NGO/5983,160,190,140,138,628,113,242,142,162,659
67,oPt,2,2017,OPT-17/DDA-3482/OPT/PROT/NGO/5984,30,200,200,30,460,0,179,204,3,386
67,oPt,2,2017,OPT-17/DDA-3482/OPT/PROT/INGO/5987,30,20,18,2,70,35,20,21,2,78
67,oPt,1,2017,OPT-17/DDA-3482/oPt/WASH/UN/6260,355597,351355,266077,262902,1235931,355597,351355,266077,262902,1235931
67,oPt,1,2017,OPT-17/DDA-3482/oPt /FSL/INGO/6650,192,245,208,233,878,268,305,216,264,1053
67,oPt,1,2017,OPT-17/DDA-3482/oPt /FSL/NGO/6658,98,42,322,336,798,120,55,363,385,923
67,oPt,1,2017,OPT-17/DDA-3482/oPt /FSL/NGO/6661,208,209,329,476,1222,213,213,486,570,1482
67,oPt,1,2017,OPT-17/DDA-3482/oPt /HNC/UN/6681,204400,158400,75600,61600,500000,128548,123406,133690,128548,514192
67,oPt,1,2017,OPT-17/DDA-3482/oPt /FSL/INGO/6710,182,176,197,191,746,262,270,286,303,1121
67,oPt,1,2017,OPT-17/DDA-3482/oPt /WASH-HNC/UN/6717,498682,481079,476574,455932,1912267,498682,481079,476574,455932,1912267
67,oPt,1,2017,OPT-17/DDA-3482/oPt /FSL/INGO/7614,535,555,653,679,2422,1145,1115,985,1006,4251
67,oPt,1,2017,OPT-17/DDA-3482/oPt /HNC/UN/7615,80,6620,12750,12750,32200,38,3019,7220,6375,16652
67,oPt,1,2017,OPT-17/DDA-3482/oPt /FSL/NGO/7616,40,40,77,75,232,63,61,72,76,272
67,oPt,1,2017,OPT-17/DDA-3482/oPt /HNC/UN/7617,114043,115018,131588,126715,487364,106384,102128,110639,106384,425535
67,oPt,1,2017,OPT-17/DDA-3482/oPt /FSL/NGO/7618,89,96,82,75,342,99,102,378,312,891
67,oPt,1,2018,OPT-18/DDA-3482/RA1/SNFI/INGO/7709,317,314,359,364,1354,399,383,432,449,1663
67,oPt,1,2018,OPT-18/DDA-3482/RA2/FSL-HNC/UN/7749,37072,35618,34221,32879,139790,28186,42327,27358,32988,130859
67,oPt,2,2018,OPT-18/DDA-3482/SA1/WASH/INGO/8994,21651,21234,25828,24727,93440,88,89,20,21,218
67,oPt,2,2018,OPT-18/DDA-3482/SA1/WASH/NGO/8999,888,854,924,888,3554,0,0,0,0,0
67,oPt,2,2018,OPT-18/DDA-3482/SA1/SNFI/NGO/9030,202,213,245,248,908,195,203,239,244,881
67,oPt,2,2018,OPT-18/DDA-3482/SA1/SNFI/INGO/9031,92,89,89,87,357,91,88,88,86,353
67,oPt,2,2018,OPT-18/DDA-3482/SA1/SNFI/INGO/9034,38,106,178,134,456,135,181,98,89,503
67,oPt,2,2018,OPT-18/DDA-3482/SA1/PROT/NGO/9094,780,8454,312,4127,13673,114,1133,151,384,1782
67,oPt,2,2018,OPT-18/DDA-3482/SA1/WASH/INGO/9134,1582,1660,1656,1687,6585,43,44,41,45,173
67,oPt,2,2018,OPT-18/DDA-3482/SA1/SNFI/INGO/9139,153,148,160,152,613,163,155,162,145,625
67,oPt,1,2018,OPT-18/DDA-3482/RA1/HNC/INGO/9171,5000,300,0,0,5300,3270,643,0,0,3913
67,oPt,1,2018,OPT-18/DDA-3482/RA1/HNC/INGO/9182,80000,5000,10000,5000,100000,117125,7320,14641,7320,146406
67,oPt,2,2018,OPT-18/DDA-3482/SA1/SNFI/INGO/9184,219,188,159,195,761,42,44,38,40,164
67,oPt,1,2018,OPT-18/DDA-3482/RA1/HNC/INGO/9196,695,82,96,5,878,25,9,24,7,65
67,oPt,1,2018,OPT-18/DDA-3482/RA1/PROT/NGO/9200,2775,1775,390,260,5200,1693,970,647,346,3656
67,oPt,1,2018,OPT-18/DDA-3482/RA2/PROT/NGO/9448,3260,990,6060,2185,12495,589,733,860,491,2673
67,oPt,1,2018,OPT-18/DDA-3482/RA2/HNC/INGO/9451,64100,13700,17000,10200,105000,76673,17664,20977,12999,128313
60,Pakistan,2,2015,PAK-15/DDA-3474/2015 (Q2) SA/P/NGO/1419,2000,2000,1000,1000,6000,2250,2570,1200,1290,7310
60,Pakistan,2,2015,PAK-15/DDA-3474/2015 (Q2) SA/E/NGO/1420,300,300,2900,2900,6400,300,300,3716,3166,7482
60,Pakistan,2,2015,PAK-15/DDA-3474/2015 (Q2) SA/WASH/NGO/1421,2258,2360,3250,2726,10594,3435,3575,2383,2290,11683
60,Pakistan,2,2015,PAK-15/DDA-3474/(Q2) SA/FS/INGO/1426,2381,2070,3105,2795,10351,1643,2407,2239,2595,8884
60,Pakistan,2,2015,PAK-15/DDA-3474/(Q2) SA/N/NGO/1430,0,13280,10364,9722,33366,0,19985,10678,10593,41256
60,Pakistan,2,2015,PAK-15/DDA-3474/(Q2) SA/CR/NGO/1434,550,200,1800,1950,4500,950,1012,1505,1394,4861
60,Pakistan,2,2015,PAK-15/DDA-3474/(Q2) SA/Shelter/NFI/NGO/1437,404,423,557,576,1960,662,698,934,839,3133
60,Pakistan,2,2015,PAK-15/DDA-3474/(Q2) SA/FS/NGO/1441,1123,1217,2246,2434,7020,1426,1399,2350,1997,7172
60,Pakistan,2,2015,PAK-15/DDA-3474/(Q2) SA/H/NGO/1442,2945,3253,4173,4479,14850,1218,5634,4294,4520,15666
60,Pakistan,2,2015,PAK-15/DDA-3474/(Q2) SA/Shelter/NFI/INGO/1445,589,639,720,781,2729,797,802,1335,1146,4080
60,Pakistan,2,2015,PAK-15/DDA-3474/(Q2) SA/Shelter/NFI/NGO/1447,326,378,437,421,1562,243,296,488,429,1456
60,Pakistan,2,2015,PAK-15/DDA-3474/(Q2) SA/E/INGO/1449,174,174,1450,1450,3248,174,174,779,1961,3088
60,Pakistan,2,2015,PAK-15/DDA-3474/(Q2) SA/N/UN/1451,0,5565,1391,1336,8292,0,5565,1391,1336,8292
60,Pakistan,2,2015,PAK-15/DDA-3474/(Q2) SA/WASH/INGO/1456,100,100,1650,1650,3500,80,70,1325,1630,3105
60,Pakistan,2,2015,PAK-15/DDA-3474/(Q2) SA/N/UN/1461,0,0,796,746,1542,0,0,364,593,957
60,Pakistan,2,2015,PAK-15/DDA-3474/(Q2) SA/Shelter/NFI/INGO/1462,778,745,907,810,3240,453,498,671,588,2210
60,Pakistan,2,2015,PAK-15/DDA-3474/(Q2) SA/P/NGO/1466,80,1000,2112,2288,5480,90,1351,2586,2135,6162
60,Pakistan,2,2015,PAK-15/DDA-3474/(Q2) SA/H/NGO/1467,2995,4118,6178,5429,18720,548,6520,4130,4739,15937
60,Pakistan,2,2015,PAK-15/DDA-3474/(Q2) SA/H/NGO/1469,3240,5093,5724,6201,20258,2657,8280,6421,6681,24039
60,Pakistan,1,2015,PAK-15/DDA-3474/2015( Q2) RA/CSS/UN/1682,1036000,1123000,650000,690000,3499000,418140,418140,563580,418140,1818000
60,Pakistan,2,2015,PAK-15/DDA-3474/2nd Standard 2015/WASH/NGO/2109,11980,12470,7987,8313,40750,0,0,0,0,0
60,Pakistan,2,2015,PAK-15/DDA-3474/2nd Standard 2015/WASH/NGO/2118,2940,3060,5440,5227,16667,11582,13789,20311,21357,67039
60,Pakistan,2,2015,PAK-15/DDA-3474/2nd Standard 2015/N/UN/2120,0,6070,2275,2186,10531,0,6639,2486,0,9125
60,Pakistan,2,2015,PAK-15/DDA-3474/2nd Standard 2015/H/NGO/2122,4147,6359,9400,7741,27647,9472,7231,4149,3867,24719
60,Pakistan,2,2015,PAK-15/DDA-3474/2nd Standard 2015/FS/NGO/2137,1872,2028,4680,5070,13650,2850,2873,4078,3818,13619
60,Pakistan,2,2015,PAK-15/DDA-3474/2nd Standard 2015/H/NGO/2141,4500,9000,4950,4050,22500,4665,9230,5078,4180,23153
60,Pakistan,2,2015,PAK-15/DDA-3474/2nd Standard 2015/N/NGO/2144,0,11543,9427,8031,29001,0,20323,13524,13245,47092
60,Pakistan,2,2015,PAK-15/DDA-3474/2nd Standard 2015/H/NGO/2148,4769,9201,8358,9054,31382,7061,9929,7909,6604,31503
60,Pakistan,2,2015,PAK-15/DDA-3474/2nd Standard 2015/E/NGO/2166,60,60,2592,2208,4920,300,300,2484,2316,5400
60,Pakistan,2,2015,PAK-15/DDA-3474/2nd Standard 2015/N/UN/2171,0,8064,786,738,9588,0,16975,10711,14545,42231
60,Pakistan,2,2015,PAK-15/DDA-3474/2nd Standard 2015/FS/INGO/2174,2331,2426,3108,3235,11100,2720,2831,3626,3774,12951
60,Pakistan,2,2015,PAK-15/DDA-3474/2nd Standard 2015/E/NGO/2175,0,0,2240,2240,4480,0,0,2240,2240,4480
60,Pakistan,2,2015,PAK-15/DDA-3474/2nd Standard 2015/H/NGO/2178,12420,12420,16740,12420,54000,15428,22317,12639,14022,64406
60,Pakistan,2,2015,PAK-15/DDA-3474/2nd Standard 2015/WASH/NGO/2188,1000,3000,1600,1600,7200,1000,3000,1750,1450,7200
60,Pakistan,2,2015,PAK-15/DDA-3474/2nd Standard 2015/N/NGO/2195,0,6646,4618,4437,15701,0,9095,7828,4880,21803
60,Pakistan,2,2016,PAK-16/DDA-3474/1st Allocation 2016/E/NGO/2964,180,180,1500,1500,3360,240,120,2000,1000,3360
60,Pakistan,2,2016,PAK-16/DDA-3474/1st Allocation 2016/Shelter/NFI/NGO/2972,139,208,223,297,867,476,382,615,562,2035
60,Pakistan,2,2016,PAK-16/DDA-3474/1st Allocation 2016/WASH/NGO/2974,2975,3180,2980,3140,12275,2975,3180,2980,3140,12275
60,Pakistan,2,2016,PAK-16/DDA-3474/1st Allocation 2016/N/NGO/2999,0,6000,4683,4392,15075,0,5295,3563,3659,12517
60,Pakistan,2,2016,PAK-16/DDA-3474/1st Allocation 2016/H/NGO/3007,5143,10180,9097,9855,34275,5143,10180,9097,9855,34275
60,Pakistan,2,2016,PAK-16/DDA-3474/1st Allocation 2016/P/NGO/3012,120,2678,4776,5162,12736,120,3233,7495,4811,15659
60,Pakistan,2,2016,PAK-16/DDA-3474/1st Allocation 2016/Shelter/NFI/INGO/3016,397,414,485,504,1800,306,308,891,754,2259
60,Pakistan,2,2016,PAK-16/DDA-3474/1st Allocation 2016/WASH/NGO/3020,3469,3588,2512,2631,12200,2512,2631,3469,3588,12200
60,Pakistan,2,2016,PAK-16/DDA-3474/1st Allocation 2016/Shelter/NFI/NGO/3025,370,352,537,455,1714,370,352,537,455,1714
60,Pakistan,2,2016,PAK-16/DDA-3474/1st Allocation 2016/P/NGO/3033,1816,2067,1172,1173,6228,1873,2067,1184,1173,6297
60,Pakistan,2,2016,PAK-16/DDA-3474/1st Allocation 2016/N/NGO/3043,0,6000,4683,4392,15075,0,10591,5157,5559,21307
60,Pakistan,2,2016,PAK-16/DDA-3474/1st Allocation 2016/E/NGO/3054,420,320,1100,1100,2940,0,0,60,10,70
60,Pakistan,2,2016,PAK-16/DDA-3474/1st Allocation 2016/P/INGO/3057,2472,2504,3373,3030,11379,4102,3569,2494,2989,13154
60,Pakistan,2,2016,PAK-16/DDA-3474/1st Allocation 2016/H/NGO/3059,6500,7250,5500,5750,25000,4330,8885,7518,7513,28246
60,Pakistan,2,2016,PAK-16/DDA-3474/1st Allocation 2016/E/NGO/3062,1354,1366,1440,1560,5720,1450,1420,1620,1580,6070
60,Pakistan,2,2016,PAK-16/DDA-3474/1st Allocation 2016/Shelter/NFI/NGO/3064,500,600,650,700,2450,290,322,695,551,1858
60,Pakistan,2,2016,PAK-16/DDA-3474/1st Allocation 2016/P/INGO/3065,900,880,400,390,2570,546,248,82,118,994
60,Pakistan,2,2016,PAK-16/DDA-3474/1st Allocation 2016/H/UN/3066,1000,10000,500,1500,13000,569,21547,0,0,22116
60,Pakistan,2,2016,PAK-16/DDA-3474/1st Allocation 2016/P/INGO/3068,900,880,400,390,2570,814,138,4,2,958
60,Pakistan,2,2016,PAK-16/DDA-3474/1st Allocation 2016/P/NGO/3069,275,1300,2400,2600,6575,0,0,0,0,0
60,Pakistan,2,2016,PAK-16/DDA-3474/1st Allocation 2016/N/UN/3070,0,5507,1143,1190,7840,0,8588,2657,2765,14010
60,Pakistan,2,2016,PAK-16/DDA-3474/1st Allocation 2016/E/NGO/3072,136,136,1500,1500,3272,1456,1280,3679,3898,10313
60,Pakistan,2,2016,PAK-16/DDA-3474/1st Allocation 2016/WASH/NGO/3089,2153,2153,4709,4440,13455,6366,6932,2583,2723,18604
60,Pakistan,2,2016,PAK-16/DDA-3474/1st Allocation 2016/Shelter/NFI/NGO/3096,246,268,186,204,904,356,312,385,258,1311
60,Pakistan,2,2016,PAK-16/DDA-3474/1st Allocation 2016/WASH/NGO/3100,2830,2945,2315,2410,10500,4748,5150,3896,3897,17691
60,Pakistan,2,2016,PAK-16/DDA-3474/1st Allocation 2016/P/UN/3102,500,3000,500,1000,5000,653,10096,49,4914,15712
60,Pakistan,2,2016,PAK-16/DDA-3474/1st Allocation 2016/N/UN/3104,0,0,120,115,235,0,0,126,131,257
60,Pakistan,2,2016,PAK-16/DDA-3474/1st Allocation 2016/N/UN/3106,0,12000,9365,8785,30150,0,4967,6212,6537,17716
60,Pakistan,2,2016,PAK-16/DDA-3474/1st Allocation 2016/WASH/NGO/3110,2400,2160,1690,1890,8140,4237,3945,3068,3360,14610
60,Pakistan,2,2016,PAK-16/DDA-3474/1st Allocation 2016/H/NGO/3111,3560,4607,6072,6701,20940,4825,5333,4611,4838,19607
60,Pakistan,1,2016,PAK-16/DDA-3474/1st Reserve Allocation 2016/CSS/UN/4429,392403,347980,0,0,740383,482885,260015,0,0,742900
60,Pakistan,1,2016,PAK-16/DDA-3474/1st Reserve Allocation 2016/CSS/UN/4430,520,280,0,0,800,47,56,93,83,279
60,Pakistan,2,2017,PAK-17/DDA-3474/1st Standard Allocation 2017/E/NGO/5829,60,65,600,600,1325,90,35,900,300,1325
60,Pakistan,2,2017,PAK-17/DDA-3474/1st Standard Allocation 2017/WASH/NGO/5870,5500,6500,6000,6000,24000,5707,6868,5734,6543,24852
60,Pakistan,2,2017,PAK-17/DDA-3474/1st Standard Allocation 2017/WASH/NGO/5880,8040,8729,2977,3225,22971,8039,8728,2977,3225,22969
60,Pakistan,2,2017,PAK-17/DDA-3474/1st Standard Allocation 2017/N/NGO/5882,0,1530,1066,980,3576,0,1539,964,1112,3615
60,Pakistan,2,2017,PAK-17/DDA-3474/1st Standard Allocation 2017/E/NGO/5904,1020,1186,824,1030,4060,1050,1218,1168,1091,4527
60,Pakistan,2,2017,PAK-17/DDA-3474/1st Standard Allocation 2017/N/UN/5926,0,20000,875,850,21725,0,8907,234,332,9473
60,Pakistan,2,2017,PAK-17/DDA-3474/1st Standard Allocation 2017/N/NGO/5943,0,3400,2428,2233,8061,0,2482,1781,2197,6460
60,Pakistan,2,2017,PAK-17/DDA-3474/1st Standard Allocation 2017/H/NGO/6028,5407,4888,4045,3810,18150,1775,3402,2028,2746,9951
60,Pakistan,2,2017,PAK-17/DDA-3474/1st Standard Allocation 2017/N/UN/6044,0,2631,1409,1295,5335,0,4021,1848,2003,7872
60,Pakistan,2,2017,PAK-17/DDA-3474/1st Standard Allocation 2017/WASH/INGO/6045,32888,26908,26908,22016,108720,0,0,0,0,0
60,Pakistan,2,2017,PAK-17/DDA-3474/1st Standard Allocation 2017/WASH/NGO/6054,4577,4795,6320,6538,22230,4577,4795,6320,6538,22230
60,Pakistan,2,2017,PAK-17/DDA-3474/1st Standard Allocation 2017/H/NGO/6080,6583,10807,12946,14024,44360,10208,19323,9218,7619,46368
60,Pakistan,2,2017,PAK-17/DDA-3474/1st Standard Allocation 2017/H/NGO/6082,9100,10150,7700,8050,35000,12110,13507,10247,10713,46577
60,Pakistan,2,2017,PAK-17/DDA-3474/1st Standard Allocation 2017/Shelter/NFI/NGO/6192,402,804,724,750,2680,454,431,639,499,2023
60,Pakistan,2,2018,PAK-18/DDA-3474/PAK 18/Shelter/NFI/NGO/7783,429,468,331,352,1580,524,578,506,551,2159
60,Pakistan,2,2018,PAK-18/DDA-3474/PAK 18/Shelter/NFI/NGO/7849,456,912,821,851,3040,0,0,0,0,0
60,Pakistan,2,2018,PAK-18/DDA-3474/PAK 18/WASH/NGO/7995,3000,3200,3800,4000,14000,151,150,428,168,897
21,Somalia,2,2010,SOM-10/DMA-0489/SA  1/A/NGO/1,143,6658,0,0,6801,230,6535,0,0,6765
21,Somalia,2,2010,SOM-10/DMA-0489/SA  1/A/INGO/2,10000,15200,0,0,25200,10000,15200,0,0,25200
21,Somalia,2,2010,SOM-10/DMA-0489/SA  1/H/INGO/3,5400,6250,0,0,11650,0,0,0,0,0
21,Somalia,2,2010,SOM-10/DMA-0489/SA  1/H/NGO/4,2000,3000,0,0,5000,1400,2850,0,0,4250
21,Somalia,2,2010,SOM-10/DMA-0489/SA  1/H/INGO/5,318419,302219,0,0,620638,318419,302219,0,0,620638
21,Somalia,2,2010,SOM-10/DMA-0489/SA  1/WASH/INGO/6,18000,42000,0,0,60000,18000,42000,0,0,60000
21,Somalia,2,2010,SOM-10/DMA-0489/SA  1/H/INGO/7,47940,46060,0,0,94000,47940,46060,0,0,94000
21,Somalia,2,2010,SOM-10/DMA-0489/SA  1/H/INGO/8,18000,18000,0,0,36000,9000,9000,0,0,18000
21,Somalia,2,2010,SOM-10/DMA-0489/SA  1/Nut/INGO/9,0,8000,0,0,8000,0,0,0,0,0
21,Somalia,2,2010,SOM-10/DMA-0489/SA  1/Nut/INGO/10,0,8000,0,0,8000,0,3400,0,0,3400
21,Somalia,2,2010,SOM-10/DMA-0489/SA  1/Nut/NGO/11,75,75,0,0,150,111,39,0,0,150
21,Somalia,2,2010,SOM-10/DMA-0489/SA  1/H/INGO/12,13410,28410,0,0,41820,25183,37775,0,0,62958
21,Somalia,2,2010,SOM-10/DMA-0489/SA  1/WASH/INGO/13,1919,2253,0,0,4172,1919,2253,0,0,4172
21,Somalia,2,2010,SOM-10/DMA-0489/SA  1/H/INGO/14,9000,26000,0,0,35000,4500,13500,0,0,18000
21,Somalia,2,2010,SOM-10/DMA-0489/SA  1/H/INGO/15,32130,30870,0,0,63000,18522,19278,0,0,37800
21,Somalia,2,2010,SOM-10/DMA-0489/SA  1/Nut/INGO/16,0,6120,0,0,6120,0,0,0,0,0
21,Somalia,2,2010,SOM-10/DMA-0489/SA  1/WASH/INGO/17,2900,4300,0,0,7200,2900,4300,0,0,7200
21,Somalia,2,2010,SOM-10/DMA-0489/SA  1/WASH/INGO/18,13300,15500,0,0,28800,12090,15700,0,0,27790
21,Somalia,2,2010,SOM-10/DMA-0489/SA  1/A/NGO/19,1055,6856,0,0,7911,10240,4096,0,0,14336
21,Somalia,1,2010,SOM-10/DMA-0489/ER /Shelter/INGO/20,2234,2839,0,0,5073,3334,2839,0,0,6173
21,Somalia,2,2010,SOM-10/DMA-0489/SA  1/WASH/INGO/21,0,0,0,0,0,6476,16189,3885,5828,32378
21,Somalia,2,2010,SOM-10/DMA-0489/SA  1/WASH/INGO/22,40290,66360,0,0,106650,40290,66360,0,0,106650
21,Somalia,2,2010,SOM-10/DMA-0489/SA  1/A/UN/23,438200,438200,0,0,876400,438200,438200,0,0,876400
21,Somalia,2,2010,SOM-10/DMA-0489/SA  1/WASH/UN/24,0,0,0,0,0,0,0,0,0,0
21,Somalia,2,2010,SOM-10/DMA-0489/SA  1/L/UN/25,0,0,0,0,0,0,0,0,0,0
21,Somalia,2,2010,SOM-10/DMA-0489/SA  1/H/UN/26,14291,17467,0,0,31758,0,0,0,0,0
21,Somalia,2,2010,SOM-10/DMA-0489/SA  1/H/UN/27,0,1270312,0,0,1270312,0,0,0,0,0
21,Somalia,2,2010,SOM-10/DMA-0489/SA  1/H/UN/28,1429101,1746679,0,0,3175780,1286191,1572011,0,0,2858202
21,Somalia,2,2010,SOM-10/DMA-0489/SA  1/EP/INGO/29,0,0,0,0,0,0,0,0,0,0
21,Somalia,2,2010,SOM-10/DMA-0489/SA  1/Nut/UN/30,0,0,0,0,0,0,0,0,0,0
21,Somalia,2,2010,SOM-10/DMA-0489/SA  1/H/INGO/31,20000,100000,0,0,120000,8000,40250,0,0,48250
21,Somalia,2,2010,SOM-10/DMA-0489/SA  1/H/INGO/32,15000,35000,0,0,50000,7000,16500,0,0,23500
21,Somalia,2,2010,SOM-10/DMA-0489/SA  1/A/NGO/33,910,2150,0,0,3060,910,2150,0,0,3060
21,Somalia,2,2010,SOM-10/DMA-0489/SA  1/A/NGO/34,1080,2518,0,0,3598,10523,11065,0,0,21588
21,Somalia,2,2010,SOM-10/DMA-0489/SA  1/A/INGO/35,300,300,0,0,600,168,1032,0,0,1200
21,Somalia,1,2010,SOM-10/DMA-0489/ER /H/NGO/36,13442,45223,0,0,58665,4352,22870,0,0,27222
21,Somalia,1,2011,SOM-11/DMA-0489/ER /A/NGO/38,5750,10700,0,0,16450,8191,15213,0,0,23404
21,Somalia,1,2011,SOM-11/DMA-0489/ER /Shelter/NGO/39,0,1500,0,0,1500,0,1500,0,0,1500
21,Somalia,1,2011,SOM-11/DMA-0489/ER /A/NGO/41,1668,2002,0,0,3670,778,334,0,0,1112
21,Somalia,1,2011,SOM-11/DMA-0489/ER /A/INGO/42,6000,6500,0,0,12500,5636,6106,0,0,11742
21,Somalia,1,2011,SOM-11/DMA-0489/ER /A/NGO/44,2400,4800,0,0,7200,2400,4800,0,0,7200
21,Somalia,1,2011,SOM-11/DMA-0489/ER /A/NGO/45,1200,1809,0,0,3009,1200,1809,0,0,3009
21,Somalia,1,2011,SOM-11/DMA-0489/ER /A/NGO/46,5218,8162,0,0,13380,5215,7632,0,0,12847
21,Somalia,1,2011,SOM-11/DMA-0489/ER /A/NGO/47,797,5183,0,0,5980,2355,5975,0,0,8330
21,Somalia,1,2011,SOM-11/DMA-0489/ER /A/INGO/48,5760,6240,0,0,12000,5760,6240,0,0,12000
21,Somalia,1,2011,SOM-11/DMA-0489/ER /A/NGO/49,610,800,0,0,1410,620,800,0,0,1420
21,Somalia,1,2011,SOM-11/DMA-0489/ER /A/INGO/50,3500,1300,0,0,4800,3500,1300,0,0,4800
21,Somalia,1,2011,SOM-11/DMA-0489/ER /A/NGO/51,2350,5875,0,0,8225,2350,5875,0,0,8225
21,Somalia,1,2011,SOM-11/DMA-0489/ER /A/NGO/52,1530,2295,0,0,3825,2356,3534,0,0,5890
21,Somalia,1,2011,SOM-11/DMA-0489/ER /A/NGO/53,1772,2750,0,0,4522,1772,2750,0,0,4522
21,Somalia,1,2011,SOM-11/DMA-0489/ER /A/NGO/54,7440,9300,0,0,16740,2833,2833,0,0,5666
21,Somalia,1,2011,SOM-11/DMA-0489/ER /A/INGO/55,1602,1900,0,0,3502,0,0,0,0,0
21,Somalia,1,2011,SOM-11/DMA-0489/ER /A/INGO/56,4120,4120,0,0,8240,4120,4120,0,0,8240
21,Somalia,1,2011,SOM-11/DMA-0489/ER /A/NGO/57,1710,1710,0,0,3420,1710,1710,0,0,3420
21,Somalia,1,2011,SOM-11/DMA-0489/ER /A/NGO/58,1762,4402,0,0,6164,2276,5732,0,0,8008
21,Somalia,1,2011,SOM-11/DMA-0489/ER /WASH/INGO/59,3510,3640,0,0,7150,6320,6680,0,0,13000
21,Somalia,1,2011,SOM-11/DMA-0489/ER /WASH/NGO/60,3500,8750,0,0,12250,8520,15980,0,0,24500
21,Somalia,1,2011,SOM-11/DMA-0489/ER /WASH/INGO/61,9200,10400,0,0,19600,8295,9377,0,0,17672
21,Somalia,1,2011,SOM-11/DMA-0489/ER /WASH/NGO/62,3875,4020,0,0,7895,8350,15770,0,0,24120
21,Somalia,1,2011,SOM-11/DMA-0489/ER /WASH/NGO/63,0,0,0,0,0,8163,8843,0,0,17006
21,Somalia,1,2011,SOM-11/DMA-0489/ER /WASH/NGO/64,9180,10120,0,0,19300,0,0,0,0,0
21,Somalia,1,2011,SOM-11/DMA-0489/ER /WASH/NGO/65,4000,10000,0,0,14000,4900,13000,0,0,17900
21,Somalia,1,2011,SOM-11/DMA-0489/ER /WASH/NGO/66,2489,3111,0,0,5600,0,0,0,0,0
21,Somalia,1,2011,SOM-11/DMA-0489/ER /WASH/INGO/67,12710,11550,0,0,24260,12080,10970,0,0,23050
21,Somalia,2,2011,SOM-11/DMA-0489/SA  1/Nut/NGO/72,4750,11200,0,0,15950,0,2850,1600,1400,5850
21,Somalia,2,2011,SOM-11/DMA-0489/SA  1/H/UN/75,984836,946215,0,0,1931051,984836,946215,0,0,1931051
21,Somalia,2,2011,SOM-11/DMA-0489/SA  1/H/NGO/76,41655,65345,0,0,107000,11730,13578,7975,8147,41430
21,Somalia,2,2011,SOM-11/DMA-0489/SA  1/H/INGO/77,96000,104000,0,0,200000,21545,57479,9769,9530,98323
21,Somalia,2,2011,SOM-11/DMA-0489/SA  1/A/NGO/78,4990,7010,0,0,12000,9131,2869,0,0,12000
21,Somalia,2,2011,SOM-11/DMA-0489/SA  1/WASH/NGO/80,4673,6477,0,0,11150,2600,3477,0,0,6077
21,Somalia,2,2011,SOM-11/DMA-0489/SA  1/Nut/INGO/90,3997,5182,0,0,9179,3392,5418,0,0,8810
21,Somalia,2,2011,SOM-11/DMA-0489/SA  1/Nut/NGO/92,2515,4355,0,0,6870,2545,4410,0,0,6955
21,Somalia,2,2011,SOM-11/DMA-0489/SA  1/H/INGO/93,206654,286246,0,0,492900,80106,93270,0,0,173376
21,Somalia,1,2011,SOM-11/DMA-0489/ER /WASH/NGO/95,5400,6600,0,0,12000,5400,6600,0,0,12000
21,Somalia,2,2011,SOM-11/DMA-0489/SA  1/H/NGO/96,0,0,0,0,0,21860,26150,0,0,48010
21,Somalia,2,2011,SOM-11/DMA-0489/SA  1/A/INGO/97,5214,6936,0,0,12150,7741,7457,0,0,15198
21,Somalia,2,2011,SOM-11/DMA-0489/SA  1/H/INGO/100,150640,225960,0,0,376600,59963,127936,0,0,187899
21,Somalia,2,2011,SOM-11/DMA-0489/SA  1/H/INGO/101,112500,137500,0,0,250000,19346,24059,0,0,43405
21,Somalia,2,2011,SOM-11/DMA-0489/SA  1/WASH/INGO/102,22743,27149,0,0,49892,5083,6777,20,30,11910
21,Somalia,2,2011,SOM-11/DMA-0489/SA  1/WASH/INGO/103,18780,23900,0,0,42680,18780,23900,0,0,42680
21,Somalia,2,2011,SOM-11/DMA-0489/SA  1/WASH/INGO/104,19218,24462,0,0,43680,19218,24462,0,0,43680
21,Somalia,1,2011,SOM-11/DMA-0489/ER /Nut/NGO/105,5223,5023,0,0,10246,1549,3160,0,0,4709
21,Somalia,2,2011,SOM-11/DMA-0489/SA  1/EP/UN/108,1960,1940,0,0,3900,544,302,242,121,1209
21,Somalia,2,2011,SOM-11/DMA-0489/SA  1/A/UN/110,75,25,0,0,100,74,13,0,0,87
21,Somalia,2,2011,SOM-11/DMA-0489/SA  1/A/NGO/111,10800,7200,0,0,18000,10800,7200,0,0,18000
21,Somalia,2,2011,SOM-11/DMA-0489/SA  1/Nut/INGO/112,1862,3438,0,0,5300,1059,1217,0,0,2276
21,Somalia,2,2011,SOM-11/DMA-0489/SA  1/H/INGO/119,8650,13247,0,0,21897,7589,9913,0,0,17502
21,Somalia,2,2011,SOM-11/DMA-0489/SA  1/A/INGO/120,5676,7224,0,0,12900,7131,9075,0,0,16206
21,Somalia,1,2011,SOM-11/DMA-0489/ER /H/UN/127,612500,637500,0,0,1250000,612500,637500,0,0,1250000
21,Somalia,2,2011,SOM-11/DMA-0489/SA  1/WASH/INGO/129,34300,35700,0,0,70000,7650,9350,0,0,17000
21,Somalia,2,2011,SOM-11/DMA-0489/SA  1/EP/INGO/132,0,0,0,0,0,0,0,0,0,0
21,Somalia,2,2011,SOM-11/DMA-0489/SA  1/H/NGO/135,8110,11890,0,0,20000,6295,11455,0,0,17750
21,Somalia,1,2011,SOM-11/DMA-0489/ER /FSC/INGO/137,36800,43200,0,0,80000,52478,54620,0,0,107098
21,Somalia,2,2011,SOM-11/DMA-0489/SA  1/A/INGO/138,810,810,0,0,1620,810,810,0,0,1620
21,Somalia,2,2011,SOM-11/DMA-0489/SA  1/WASH/NGO/142,8490,8460,0,0,16950,5304,6201,0,0,11505
21,Somalia,1,2011,SOM-11/DMA-0489/ER /H/UN/144,294000,306000,0,0,600000,294000,306000,0,0,600000
21,Somalia,2,2011,SOM-11/DMA-0489/SA  1/WASH/INGO/145,25079,27169,0,0,52248,13579,14711,0,0,28290
21,Somalia,2,2011,SOM-11/DMA-0489/SA  1/A/INGO/152,6020,5369,0,0,11389,13257,11824,0,0,25081
21,Somalia,2,2011,SOM-11/DMA-0489/SA  1/WASH/INGO/153,21000,26000,0,0,47000,20655,25245,0,0,45900
21,Somalia,2,2011,SOM-11/DMA-0489/SA  1/A/NGO/156,7300,9200,0,0,16500,7300,9200,0,0,16500
21,Somalia,2,2011,SOM-11/DMA-0489/SA  1/H/NGO/161,39500,50500,0,0,90000,3100,12354,0,0,15454
21,Somalia,2,2011,SOM-11/DMA-0489/SA  1/A/NGO/165,1200,2800,0,0,4000,915,2635,0,0,3550
21,Somalia,2,2011,SOM-11/DMA-0489/SA  1/A/NGO/166,3000,9000,0,0,12000,3000,9000,0,0,12000
21,Somalia,2,2011,SOM-11/DMA-0489/SA  1/Nut/NGO/168,3000,4552,0,0,7552,1200,1820,0,0,3020
21,Somalia,2,2011,SOM-11/DMA-0489/SA  1/H/NGO/169,3874,7544,0,0,11418,3694,7446,0,0,11140
21,Somalia,2,2011,SOM-11/DMA-0489/SA  1/Nut/NGO/170,2303,3402,0,0,5705,474,926,0,0,1400
21,Somalia,2,2011,SOM-11/DMA-0489/SA  1/WASH/NGO/171,10060,13180,0,0,23240,10060,13180,10060,13180,46480
21,Somalia,2,2011,SOM-11/DMA-0489/SA  1/Shelter/INGO/175,7920,11880,0,0,19800,5940,8910,0,0,14850
21,Somalia,2,2011,SOM-11/DMA-0489/SA  1/Nut/NGO/178,2500,3500,0,0,6000,748,1252,0,0,2000
21,Somalia,2,2011,SOM-11/DMA-0489/SA  1/Nut/NGO/188,1961,3363,0,0,5324,3504,9389,0,0,12893
21,Somalia,2,2011,SOM-11/DMA-0489/SA  1/WASH/NGO/190,18240,19760,0,0,38000,13886,15044,0,0,28930
21,Somalia,2,2011,SOM-11/DMA-0489/SA  1/A/INGO/193,1050,550,0,0,1600,655,321,0,0,976
21,Somalia,2,2011,SOM-11/DMA-0489/SA  1/Shelter/INGO/194,2745,3351,0,0,6096,0,0,0,0,0
21,Somalia,2,2011,SOM-11/DMA-0489/SA  1/EP/INGO/196,0,0,0,0,0,0,0,0,0,0
21,Somalia,2,2011,SOM-11/DMA-0489/SA  1/H/INGO/202,22000,23000,0,0,45000,9780,10435,5670,6790,32675
21,Somalia,2,2011,SOM-11/DMA-0489/SA  1/Nut/INGO/203,20065,28466,0,0,48531,64160,95217,0,0,159377
21,Somalia,2,2011,SOM-11/DMA-0489/SA  1/A/INGO/204,6700,8000,0,0,14700,0,0,0,0,0
21,Somalia,2,2011,SOM-11/DMA-0489/SA  1/WASH/UN/210,0,0,0,0,0,0,0,0,0,0
21,Somalia,2,2011,SOM-11/DMA-0489/SA  1/A/INGO/215,3780,6720,0,0,10500,1889,2084,1080,1621,6674
21,Somalia,2,2011,SOM-11/DMA-0489/SA  1/H/INGO/218,44928,46761,0,0,91689,28296,29450,0,0,57746
21,Somalia,2,2011,SOM-11/DMA-0489/SA  1/A/NGO/219,10400,19600,0,0,30000,10640,19915,0,0,30555
21,Somalia,2,2011,SOM-11/DMA-0489/SA  1/WASH/INGO/224,27191,37549,0,0,64740,14184,18776,0,0,32960
21,Somalia,2,2011,SOM-11/DMA-0489/SA  1/FSC/UN/230,219000,219000,0,0,438000,240126,240126,0,0,480252
21,Somalia,2,2011,SOM-11/DMA-0489/SA  1/WASH/NGO/234,11280,16820,0,0,28100,4005,9975,0,0,13980
21,Somalia,2,2011,SOM-11/DMA-0489/SA  1/H/UN/237,136305,147662,0,0,283967,107000,130000,0,0,237000
21,Somalia,2,2011,SOM-11/DMA-0489/SA  1/H/NGO/246,33280,49920,0,0,83200,13190,21510,2565,3120,40385
21,Somalia,2,2011,SOM-11/DMA-0489/SA  1/A/INGO/248,3302,4954,0,0,8256,33,0,0,0,33
21,Somalia,2,2011,SOM-11/DMA-0489/SA  1/A/NGO/249,45520,68280,0,0,113800,2510,3660,550,900,7620
21,Somalia,2,2011,SOM-11/DMA-0489/SA  1/A/NGO/253,3083,3769,0,0,6852,3517,3112,0,0,6629
21,Somalia,1,2011,SOM-11/DMA-0489/ER /A/NGO/258,10200,12660,0,0,22860,7800,15060,0,0,22860
21,Somalia,1,2011,SOM-11/DMA-0489/ER /WASH/NGO/259,7300,9020,0,0,16320,7300,9020,0,0,16320
21,Somalia,2,2011,SOM-11/DMA-0489/SA  1/WASH/INGO/263,9664,10472,0,0,20136,4753,5321,0,0,10074
21,Somalia,2,2011,SOM-11/DMA-0489/SA  1/WASH/UN/264,930720,696840,0,0,1627560,49414,37278,0,0,86692
21,Somalia,2,2011,SOM-11/DMA-0489/SA  1/WASH/INGO/265,6599,9226,0,0,15825,4016,5126,0,0,9142
21,Somalia,2,2011,SOM-11/DMA-0489/SA  1/Nut/UN/266,9988,9988,0,0,19976,10794,10373,0,0,21167
21,Somalia,2,2011,SOM-11/DMA-0489/SA  1/Shelter/UN/268,3000,3000,0,0,6000,3480,4253,0,0,7733
21,Somalia,2,2011,SOM-11/DMA-0489/SA  1/H/INGO/270,120865,125798,0,0,246663,0,0,0,0,0
21,Somalia,2,2011,SOM-11/DMA-0489/SA  1/Nut/NGO/272,1200,1800,0,0,3000,304,588,0,0,892
21,Somalia,2,2011,SOM-11/DMA-0489/SA  1/H/UN/274,861500,1461500,0,0,2323000,188160,195840,0,0,384000
21,Somalia,2,2011,SOM-11/DMA-0489/SA  1/A/INGO/280,11500,14900,0,0,26400,8640,9360,0,0,18000
21,Somalia,2,2011,SOM-11/DMA-0489/SA  1/WASH/INGO/283,13500,22500,0,0,36000,0,0,0,0,0
21,Somalia,2,2011,SOM-11/DMA-0489/SA  1/Prot/UN/284,300,364,0,0,664,334,431,0,0,765
21,Somalia,2,2011,SOM-11/DMA-0489/SA  1/EP/UN/291,3751327,3751327,0,0,7502654,3751327,3751327,0,0,7502654
21,Somalia,2,2011,SOM-11/DMA-0489/SA  1/WASH/NGO/301,7457,14913,0,0,22370,5844,6331,0,0,12175
21,Somalia,2,2011,SOM-11/DMA-0489/SA  1/Nut/NGO/304,3750,5800,0,0,9550,0,0,0,0,0
21,Somalia,2,2011,SOM-11/DMA-0489/SA  1/A/INGO/306,13395,13395,0,0,26790,260,260,0,0,520
21,Somalia,1,2011,SOM-11/DMA-0489/ER /Ed/INGO/313,1280,1920,0,0,3200,960,1210,0,0,2170
21,Somalia,2,2011,SOM-11/DMA-0489/SA  1/Nut/NGO/321,2000,8000,0,0,10000,16,1900,810,1065,3791
21,Somalia,2,2011,SOM-11/DMA-0489/SA  1/Ed/INGO/322,0,0,0,0,0,0,0,0,0,0
21,Somalia,2,2011,SOM-11/DMA-0489/SA  1/A/INGO/323,2137,2315,0,0,4452,3599,5161,0,0,8760
21,Somalia,2,2011,SOM-11/DMA-0489/SA  1/A/INGO/324,600,300,0,0,900,519,502,0,0,1021
21,Somalia,2,2011,SOM-11/DMA-0489/SA  1/Shelter/INGO/329,5214,6372,0,0,11586,2392,2923,0,0,5315
21,Somalia,2,2011,SOM-11/DMA-0489/SA  1/A/UN/330,76126,50750,0,0,126876,78246,33534,0,0,111780
21,Somalia,2,2011,SOM-11/DMA-0489/SA  1/H/UN/331,20,15,0,0,35,20,20,0,0,40
21,Somalia,2,2011,SOM-11/DMA-0489/SA  1/A/UN/337,51508,34322,0,0,85830,48859,20939,0,0,69798
21,Somalia,1,2011,SOM-11/DMA-0489/ER /WASH/INGO/365,8500,12500,0,0,21000,0,0,0,0,0
21,Somalia,1,2011,SOM-11/DMA-0489/ER /WASH/NGO/369,10204,11054,0,0,21258,10204,11054,0,0,21258
21,Somalia,1,2011,SOM-11/DMA-0489/ER /FSC/NGO/387,5073,9088,0,0,14161,5073,9088,0,0,14161
21,Somalia,1,2011,SOM-11/DMA-0489/ER /H/UN/389,4900,5100,0,0,10000,4900,5100,0,0,10000
21,Somalia,1,2011,SOM-11/DMA-0489/ER /WASH/NGO/391,3240,7560,0,0,10800,3240,7560,0,0,10800
21,Somalia,1,2011,SOM-11/DMA-0489/ER /Shelter/NGO/405,314,2000,0,0,2314,314,2000,0,0,2314
21,Somalia,1,2011,SOM-11/DMA-0489/ER /WASH/INGO/411,9509,14263,0,0,23772,3855,6661,8175,8321,27012
21,Somalia,1,2011,SOM-11/DMA-0489/ER /WASH/NGO/412,43338,43344,0,0,86682,21255,22996,0,0,44251
21,Somalia,1,2011,SOM-11/DMA-0489/ER /WASH/NGO/418,9484,12572,0,0,22056,9484,12572,0,0,22056
21,Somalia,1,2011,SOM-11/DMA-0489/ER /FSC/NGO/436,1275,1942,0,0,3217,1275,1942,795,1032,5044
21,Somalia,1,2011,SOM-11/DMA-0489/ER /WASH/NGO/452,7346,13642,0,0,20988,1584,2376,0,0,3960
21,Somalia,1,2011,SOM-11/DMA-0489/ER /H/INGO/453,0,0,0,0,0,236,1585,2417,2694,6932
21,Somalia,1,2011,SOM-11/DMA-0489/ER /Nut/INGO/454,1263,2027,0,0,3290,0,839,1648,1691,4178
21,Somalia,1,2011,SOM-11/DMA-0489/ER /A/NGO/461,2070,4830,0,0,6900,943,2346,1587,2024,6900
21,Somalia,1,2011,SOM-11/DMA-0489/ER /A/NGO/483,3600,5400,0,0,9000,3600,5400,2400,3600,15000
21,Somalia,1,2011,SOM-11/DMA-0489/ER /A/NGO/485,3667,5533,0,0,9200,4167,6033,0,0,10200
21,Somalia,1,2011,SOM-11/DMA-0489/ER /A/INGO/488,4392,6588,0,0,10980,4392,6588,0,0,10980
21,Somalia,1,2011,SOM-11/DMA-0489/ER /A/NGO/493,11969,14629,0,0,26598,11969,14628,3590,4189,34376
21,Somalia,1,2011,SOM-11/DMA-0489/ER /A/INGO/498,6863,8737,0,0,15600,4224,5376,0,0,9600
21,Somalia,1,2011,SOM-11/DMA-0489/ER /A/INGO/505,2700,2700,0,0,5400,10501,10589,0,0,21090
21,Somalia,1,2011,SOM-11/DMA-0489/ER /WASH/NGO/513,6480,15120,0,0,21600,3240,6695,4105,7560,21600
21,Somalia,1,2011,SOM-11/DMA-0489/ER /A/NGO/515,7800,9000,0,0,16800,6510,10290,0,0,16800
21,Somalia,1,2011,SOM-11/DMA-0489/ER /A/NGO/516,3759,6981,0,0,10740,3712,6856,0,0,10568
21,Somalia,1,2011,SOM-11/DMA-0489/ER /H/NGO/517,7600,30400,0,0,38000,2730,10100,0,0,12830
21,Somalia,1,2011,SOM-11/DMA-0489/ER /A/NGO/524,3866,6874,0,0,10740,3901,6744,0,0,10645
21,Somalia,1,2011,SOM-11/DMA-0489/ER /A/NGO/527,2073,3849,0,0,5922,2073,3849,0,0,5922
21,Somalia,1,2011,SOM-11/DMA-0489/ER /Shelter/INGO/528,17420,32770,0,0,50190,13130,24370,0,0,37500
21,Somalia,1,2011,SOM-11/DMA-0489/ER /A/NGO/529,3917,7274,0,0,11191,5660,8299,0,0,13959
21,Somalia,1,2011,SOM-11/DMA-0489/ER /A/NGO/537,3780,8820,0,0,12600,3820,8780,0,0,12600
21,Somalia,1,2011,SOM-11/DMA-0489/ER /FSC/NGO/543,1940,3010,0,0,4950,1940,3010,0,0,4950
21,Somalia,1,2011,SOM-11/DMA-0489/ER /FSC/NGO/544,6930,12870,0,0,19800,6930,12870,22600,12870,55270
21,Somalia,1,2011,SOM-11/DMA-0489/ER /FSC/NGO/546,3850,3850,0,0,7700,0,0,0,0,0
21,Somalia,1,2011,SOM-11/DMA-0489/ER /A/INGO/550,5728,7292,0,0,13020,6490,6515,0,0,13005
21,Somalia,2,2011,SOM-11/DMA-0489/SA  2/WASH/NGO/552,7010,7122,9892,9892,33916,7010,7122,9892,18372,42396
21,Somalia,1,2011,SOM-11/DMA-0489/ER /Nut/NGO/556,2300,8990,0,0,11290,558,3497,0,0,4055
21,Somalia,1,2011,SOM-11/DMA-0489/ER /A/NGO/560,5909,8863,0,0,14772,5909,8863,0,0,14772
21,Somalia,2,2011,SOM-11/DMA-0489/SA  2/Nut/NGO/561,0,800,1600,1600,4000,0,455,775,656,1886
21,Somalia,1,2011,SOM-11/DMA-0489/ER /Nut/INGO/562,7708,7709,0,0,15417,0,0,0,0,0
21,Somalia,1,2011,SOM-11/DMA-0489/ER /A/NGO/566,3893,7231,0,0,11124,3893,7231,0,0,11124
21,Somalia,2,2011,SOM-11/DMA-0489/SA  2/Nut/NGO/571,1667,2897,0,0,4564,1608,2848,1608,1608,7672
21,Somalia,1,2011,SOM-11/DMA-0489/ER /A/INGO/578,5838,5667,0,0,11505,0,0,0,0,0
21,Somalia,1,2011,SOM-11/DMA-0489/ER /H/INGO/581,75000,75000,0,0,150000,39964,41101,0,0,81065
21,Somalia,1,2011,SOM-11/DMA-0489/ER /FSC/NGO/582,3482,6466,0,0,9948,4778,5951,0,0,10729
21,Somalia,2,2011,SOM-11/DMA-0489/SA  2/Nut/NGO/586,0,3500,3000,3000,9500,0,2000,2750,2750,7500
21,Somalia,1,2011,SOM-11/DMA-0489/ER /A/NGO/594,2454,2646,0,0,5100,2454,2646,0,0,5100
21,Somalia,1,2011,SOM-11/DMA-0489/ER /A/INGO/599,3600,5400,0,0,9000,3600,5400,0,0,9000
21,Somalia,2,2011,SOM-11/DMA-0489/SA  2/H/INGO/600,10000,28000,17000,17000,72000,4320,14524,8230,8642,35716
21,Somalia,1,2011,SOM-11/DMA-0489/ER /WASH/NGO/613,20625,46875,0,0,67500,13475,19825,0,0,33300
21,Somalia,1,2011,SOM-11/DMA-0489/ER /Shelter/UN/638,36000,36000,0,0,72000,12710,12709,0,0,25419
21,Somalia,1,2011,SOM-11/DMA-0489/ER /A/INGO/641,5280,6720,0,0,12000,2276,2135,2501,3183,10095
21,Somalia,1,2011,SOM-11/DMA-0489/ER /A/NGO/647,8867,11353,0,0,20220,8867,11353,0,0,20220
21,Somalia,2,2011,SOM-11/DMA-0489/SA  2/Shelter/NGO/650,16704,17309,5777,5777,45567,14125,14125,3754,3754,35758
21,Somalia,1,2011,SOM-11/DMA-0489/ER /A/INGO/658,2189,2371,0,0,4560,2189,2371,0,0,4560
21,Somalia,1,2011,SOM-11/DMA-0489/ER /A/NGO/662,5400,12600,5400,5400,28800,5400,12600,5400,12600,36000
21,Somalia,1,2011,SOM-11/DMA-0489/ER /Prot/INGO/664,16000,24000,0,0,40000,5409,8957,991,1923,17280
21,Somalia,1,2011,SOM-11/DMA-0489/ER /Prot/NGO/665,200,400,0,0,600,195,340,0,0,535
21,Somalia,1,2011,SOM-11/DMA-0489/ER /WASH/INGO/671,5975,7794,6345,6345,26459,5340,7213,6000,11430,29983
21,Somalia,2,2011,SOM-11/DMA-0489/SA  2/Nut/NGO/673,0,3229,3229,3229,9687,778,2190,778,2190,5936
21,Somalia,1,2011,SOM-11/DMA-0489/ER /WASH/INGO/681,10560,13440,0,0,24000,3301,5438,5243,5438,19420
21,Somalia,1,2011,SOM-11/DMA-0489/ER /WASH/NGO/683,21200,28499,0,0,49699,20400,30000,0,0,50400
21,Somalia,1,2011,SOM-11/DMA-0489/ER /A/NGO/693,6120,9180,0,0,15300,2857,4284,3263,4896,15300
21,Somalia,1,2011,SOM-11/DMA-0489/ER /A/NGO/700,8250,9150,0,0,17400,8766,8634,0,0,17400
21,Somalia,1,2011,SOM-11/DMA-0489/ER /Shelter/NGO/732,2995,3245,780,780,7800,22995,3245,780,780,27800
21,Somalia,1,2011,SOM-11/DMA-0489/ER /WASH/NGO/755,9750,11700,7700,7700,36850,6825,8190,5390,6860,27265
21,Somalia,2,2011,SOM-11/DMA-0489/SA  2/Nut/NGO/766,0,500,1500,1500,3500,0,365,568,852,1785
21,Somalia,2,2011,SOM-11/DMA-0489/SA  2/WASH/NGO/776,7460,13250,14970,14970,50650,3450,5970,6453,6876,22749
21,Somalia,2,2011,SOM-11/DMA-0489/SA  2/WASH/NGO/785,5220,9960,7830,7830,30840,5220,9960,7830,14940,37950
21,Somalia,1,2011,SOM-11/DMA-0489/ER /H/NGO/789,34440,51660,0,0,86100,19600,29839,0,0,49439
21,Somalia,2,2011,SOM-11/DMA-0489/SA  2/WASH/NGO/800,3994,7417,9700,9700,30811,3994,7417,9700,13123,34234
21,Somalia,1,2011,SOM-11/DMA-0489/ER /H/INGO/809,5760,5760,2880,2880,17280,540,566,199,213,1518
21,Somalia,2,2011,SOM-11/DMA-0489/SA  2/Nut/NGO/909,0,5599,4650,4650,14899,0,3000,2500,2500,8000
21,Somalia,2,2011,SOM-11/DMA-0489/SA  2/Nut/INGO/911,0,997,1652,1652,4301,0,997,1652,1789,4438
21,Somalia,2,2011,SOM-11/DMA-0489/SA  2/H/NGO/912,3000,9000,3000,3000,18000,340,630,1135,1135,3240
21,Somalia,2,2011,SOM-11/DMA-0489/SA  2/Nut/INGO/917,0,5662,6292,6292,18246,0,2702,3246,3040,8988
21,Somalia,2,2011,SOM-11/DMA-0489/SA  2/H/INGO/919,22336,27998,6292,6292,62918,10897,19201,3986,3709,37793
21,Somalia,2,2011,SOM-11/DMA-0489/SA  2/H/NGO/924,25100,34900,0,0,60000,10705,15650,0,0,26355
21,Somalia,2,2011,SOM-11/DMA-0489/SA  2/Shelter/INGO/945,8100,8100,14580,14580,45360,8100,8100,14580,17820,48600
21,Somalia,2,2011,SOM-11/DMA-0489/SA  2/Shelter/NGO/955,800,1200,250,250,2500,800,1200,250,250,2500
21,Somalia,2,2011,SOM-11/DMA-0489/SA  2/Shelter/INGO/966,4000,4000,0,0,8000,4000,4000,0,0,8000
21,Somalia,2,2011,SOM-11/DMA-0489/SA  2/H/UN/967,0,0,0,0,0,0,0,0,0,0
21,Somalia,2,2011,SOM-11/DMA-0489/SA  2/Nut/NGO/968,0,2000,1500,1500,5000,0,144,694,680,1518
21,Somalia,2,2011,SOM-11/DMA-0489/SA  2/Nut/INGO/970,0,1600,2030,2030,5660,0,78,0,0,78
21,Somalia,2,2011,SOM-11/DMA-0489/SA  2/H/INGO/971,54615,127435,22756,22756,227562,39922,52429,11485,11485,115321
21,Somalia,2,2011,SOM-11/DMA-0489/SA  2/Nut/INGO/973,0,15219,14152,14152,43523,0,0,0,0,0
21,Somalia,2,2011,SOM-11/DMA-0489/SA  2/Shelter/INGO/983,2410,2410,6025,6025,16870,205,1849,2396,2396,6846
21,Somalia,2,2011,SOM-11/DMA-0489/SA  2/H/NGO/984,20000,40000,0,0,60000,9071,14338,0,0,23409
21,Somalia,2,2011,SOM-11/DMA-0489/SA  2/Shelter/INGO/995,6559,10802,10417,10417,38195,6559,10802,10417,10802,38580
21,Somalia,2,2011,SOM-11/DMA-0489/SA  2/Nut/NGO/1000,0,4000,2500,2500,9000,0,0,0,0,0
21,Somalia,2,2011,SOM-11/DMA-0489/SA  2/Nut/NGO/1004,0,5284,4810,4810,14904,1417,0,3287,2338,7042
21,Somalia,2,2011,SOM-11/DMA-0489/SA  2/Nut/NGO/1011,0,5000,2400,2400,9800,0,2575,454,628,3657
21,Somalia,2,2011,SOM-11/DMA-0489/SA  2/Nut/NGO/1018,0,5873,3524,3524,12921,0,2937,1762,2643,7342
21,Somalia,2,2011,SOM-11/DMA-0489/SA  2/H/NGO/1020,2200,5500,3200,3200,14100,1000,2400,1500,2100,7000
21,Somalia,2,2011,SOM-11/DMA-0489/SA  2/Nut/NGO/1023,0,1800,2110,2110,6020,0,890,95,101,1086
21,Somalia,2,2011,SOM-11/DMA-0489/SA  2/Shelter/UN/1024,1812,1208,0,0,3020,2648,1765,0,0,4413
21,Somalia,2,2011,SOM-11/DMA-0489/SA  2/Prot/UN/1025,1812,1208,0,0,3020,1644,1096,0,0,2740
21,Somalia,2,2011,SOM-11/DMA-0489/SA  2/H/NGO/1037,6400,20800,3500,3500,34200,3019,12640,1568,2800,20027
21,Somalia,2,2011,SOM-11/DMA-0489/SA  2/WASH/NGO/1039,5986,11118,8980,8980,35064,4788,8892,7187,13339,34206
21,Somalia,2,2011,SOM-11/DMA-0489/SA  2/H/INGO/1040,21800,46200,36700,36700,141400,9347,11488,8504,11080,40419
21,Somalia,2,2011,SOM-11/DMA-0489/SA  2/H/NGO/1041,1400,10500,5600,5600,23100,1286,7205,3717,5212,17420
21,Somalia,2,2011,SOM-11/DMA-0489/SA  2/H/NGO/1042,4160,6240,6240,6240,22880,3100,2950,3900,5200,15150
21,Somalia,2,2011,SOM-11/DMA-0489/SA  2/WASH/NGO/1045,3500,18800,2350,2350,27000,380,5250,1794,1806,9230
21,Somalia,2,2011,SOM-11/DMA-0489/SA  2/WASH/NGO/1053,4160,6240,6240,6240,22880,2030,3550,3260,4700,13540
21,Somalia,2,2011,SOM-11/DMA-0489/SA  2/WASH/NGO/1055,4650,10720,3550,3550,22470,2500,5000,2000,3500,13000
21,Somalia,2,2011,SOM-11/DMA-0489/SA  2/H/NGO/1061,14993,14263,3657,3657,36570,4015,7474,3003,2826,17318
21,Somalia,2,2011,SOM-11/DMA-0489/SA  2/WASH/INGO/1069,4150,10500,10000,10000,34650,4150,10500,10000,11000,35650
21,Somalia,2,2011,SOM-11/DMA-0489/SA  2/WASH/NGO/1070,4918,6831,5738,5738,23225,4918,6831,5738,9837,27324
21,Somalia,1,2011,SOM-11/DMA-0489/ER /Shelter/INGO/1107,20000,30400,6300,6300,63000,0,0,0,0,0
21,Somalia,2,2011,SOM-11/DMA-0489/SA  2/Nut/NGO/1126,0,3000,5023,5023,13046,0,1490,2345,2894,6729
21,Somalia,1,2012,SOM-12/DMA-0489/ER /WASH/INGO/1128,10770,17847,17428,17428,63473,1248,2028,2028,2496,7800
21,Somalia,1,2012,SOM-12/DMA-0489/ER /WASH/NGO/1129,21494,34851,16490,16490,89325,21494,34851,16490,19361,92196
21,Somalia,1,2012,SOM-12/DMA-0489/ER /Shelter/INGO/1131,13160,13160,3290,3290,32900,13108,13320,3321,3876,33625
21,Somalia,2,2012,SOM-12/DMA-0489/SA  1/Shelter/INGO/1133,8520,20880,22380,22380,74160,8020,20000,22000,22000,72020
21,Somalia,1,2012,SOM-12/DMA-0489/ER /WASH/NGO/1135,7366,7366,10000,10000,34732,7366,7366,100000,12000,126732
21,Somalia,1,2012,SOM-12/DMA-0489/ER /WASH/NGO/1145,11512,26042,15900,15900,69354,10457,27163,15900,18546,72066
21,Somalia,2,2012,SOM-12/DMA-0489/SA  1/Shelter/NGO/1149,16344,17707,4256,4256,42563,8937,9682,2327,2328,23274
21,Somalia,2,2012,SOM-12/DMA-0489/SA  1/Prot/INGO/1152,8943,13402,8660,8660,39665,3492,5462,1572,3004,13530
21,Somalia,2,2012,SOM-12/DMA-0489/SA  1/Nut/NGO/1153,0,2548,1542,1542,5632,0,2548,1542,1542,5632
21,Somalia,2,2012,SOM-12/DMA-0489/SA  1/WASH/NGO/1156,5617,7021,7022,7022,26682,4162,6121,5412,6126,21821
21,Somalia,2,2012,SOM-12/DMA-0489/SA  1/Prot/INGO/1158,17612,26418,22015,22015,88060,13490,20236,20236,30354,84316
21,Somalia,2,2012,SOM-12/DMA-0489/SA  1/FSC/NGO/1161,1796,2011,661,661,5129,1796,2011,661,992,5460
21,Somalia,2,2012,SOM-12/DMA-0489/SA  1/Nut/NGO/1163,195,5195,4500,4500,14390,11,4,2041,1943,3999
21,Somalia,2,2012,SOM-12/DMA-0489/SA  1/H/NGO/1165,7500,22500,5000,5000,40000,3728,10122,2525,2772,19147
21,Somalia,2,2012,SOM-12/DMA-0489/SA  1/A/NGO/1172,290,1570,2910,2910,7680,290,1570,2910,2910,7680
21,Somalia,2,2012,SOM-12/DMA-0489/SA  1/Nut/NGO/1175,0,1200,5000,5000,11200,0,600,2500,2000,5100
21,Somalia,2,2012,SOM-12/DMA-0489/SA  1/WASH/NGO/1176,8095,24095,30457,30457,93104,3000,5600,8300,8900,25800
21,Somalia,2,2012,SOM-12/DMA-0489/SA  1/Prot/NGO/1183,100,9200,0,0,9300,1562,3638,0,0,5200
21,Somalia,2,2012,SOM-12/DMA-0489/SA  1/WASH/NGO/1185,3350,9600,3150,3150,19250,1500,5000,1500,2500,10500
21,Somalia,2,2012,SOM-12/DMA-0489/SA  1/Shelter/INGO/1187,5198,6353,4252,4252,20055,1588,2383,2379,3569,9919
21,Somalia,2,2012,SOM-12/DMA-0489/SA  1/H/INGO/1188,16700,25256,16884,16884,75724,16700,25256,16884,25348,84188
21,Somalia,2,2012,SOM-12/DMA-0489/SA  1/WASH/INGO/1190,13200,19800,0,0,33000,0,0,0,0,0
21,Somalia,2,2012,SOM-12/DMA-0489/SA  1/H/NGO/1193,8120,11880,0,0,20000,3240,4555,0,0,7795
21,Somalia,2,2012,SOM-12/DMA-0489/SA  1/WASH/INGO/1194,6032,7678,9254,9254,32218,0,0,0,0,0
21,Somalia,2,2012,SOM-12/DMA-0489/SA  1/A/INGO/1196,5352,4746,4296,4296,18690,5426,4832,4354,4028,18640
21,Somalia,2,2012,SOM-12/DMA-0489/SA  1/H/INGO/1202,22336,27998,6292,6292,62918,14518,20998,4719,4348,44583
21,Somalia,2,2012,SOM-12/DMA-0489/SA  1/H/INGO/1205,4000,31000,10000,10000,55000,2964,21754,6586,6246,37550
21,Somalia,1,2012,SOM-12/DMA-0489/ER /A/NGO/1207,1190,400,0,0,1590,1224,366,0,0,1590
21,Somalia,2,2012,SOM-12/DMA-0489/SA  1/Prot/UN/1208,200000,500000,0,0,700000,200000,500000,0,0,700000
21,Somalia,2,2012,SOM-12/DMA-0489/SA  1/Nut/NGO/1209,0,986,1458,1458,3902,0,216,568,629,1413
21,Somalia,2,2012,SOM-12/DMA-0489/SA  1/WASH/INGO/1213,7824,8015,5890,5890,27619,1654,2081,3062,3126,9923
21,Somalia,2,2012,SOM-12/DMA-0489/SA  1/WASH/UN/1214,25650,19350,0,0,45000,65790,87210,0,0,153000
21,Somalia,2,2012,SOM-12/DMA-0489/SA  1/WASH/NGO/1224,6962,10888,12928,12928,43706,2210,3320,3980,6390,15900
21,Somalia,2,2012,SOM-12/DMA-0489/SA  1/A/NGO/1226,3862,4915,0,0,8777,3852,4925,0,0,8777
21,Somalia,2,2012,SOM-12/DMA-0489/SA  1/Prot/INGO/1228,185,184,4100,4100,8569,26,14,2525,1989,4554
21,Somalia,2,2012,SOM-12/DMA-0489/SA  1/A/NGO/1229,1821,5463,4552,4552,16388,1376,1251,1517,2125,6269
21,Somalia,2,2012,SOM-12/DMA-0489/SA  1/Nut/NGO/1231,0,1000,850,850,2700,0,570,475,520,1565
21,Somalia,2,2012,SOM-12/DMA-0489/SA  1/Shelter/UN/1234,32536,33864,32536,32536,131472,9390,11476,14092,17223,52181
21,Somalia,2,2012,SOM-12/DMA-0489/SA  1/H/INGO/1238,40248,48301,10052,10052,108653,12670,14727,10526,9335,47258
21,Somalia,2,2012,SOM-12/DMA-0489/SA  1/Shelter/UN/1239,2100,900,0,0,3000,919,1717,0,0,2636
21,Somalia,2,2012,SOM-12/DMA-0489/SA  1/Nut/NGO/1242,50,3300,3225,3225,9800,50,1700,1750,1653,5153
21,Somalia,2,2012,SOM-12/DMA-0489/SA  1/Nut/INGO/1249,0,5992,6292,6292,18576,0,4200,3720,4340,12260
21,Somalia,2,2012,SOM-12/DMA-0489/SA  1/EP/INGO/1252,0,0,0,0,0,0,0,0,0,0
21,Somalia,2,2012,SOM-12/DMA-0489/SA  1/Nut/NGO/1255,308,1438,862,862,3470,353,1445,568,616,2982
21,Somalia,2,2012,SOM-12/DMA-0489/SA  1/H/NGO/1258,9000,18000,12000,12000,51000,3845,7900,5700,12000,29445
21,Somalia,2,2012,SOM-12/DMA-0489/SA  1/H/UN/1259,200,33872,0,0,34072,100,4485,0,0,4585
21,Somalia,2,2012,SOM-12/DMA-0489/SA  1/A/INGO/1263,6657,2852,0,0,9509,5046,2142,0,0,7188
21,Somalia,2,2012,SOM-12/DMA-0489/SA  1/A/NGO/1268,1450,2980,1350,1350,7130,1450,2980,1350,1530,7310
21,Somalia,2,2012,SOM-12/DMA-0489/SA  1/WASH/NGO/1269,3685,5528,3517,3517,16247,2027,3040,1935,2211,9213
21,Somalia,2,2012,SOM-12/DMA-0489/SA  1/A/INGO/1273,1600,1600,3350,3350,9900,3150,2500,2150,1958,9758
21,Somalia,2,2012,SOM-12/DMA-0489/SA  1/Nut/NGO/1274,0,5000,3850,3850,12700,0,2550,1638,1512,5700
21,Somalia,2,2012,SOM-12/DMA-0489/SA  1/Nut/NGO/1277,102,4396,7000,7000,18498,102,1758,3525,3664,9049
21,Somalia,2,2012,SOM-12/DMA-0489/SA  1/A/INGO/1280,2859,4711,4542,4542,16654,2859,4711,4542,4711,16823
21,Somalia,2,2012,SOM-12/DMA-0489/SA  1/Nut/INGO/1281,40,4272,6031,6031,16374,9,3060,6008,6231,15308
21,Somalia,2,2012,SOM-12/DMA-0489/SA  1/WASH/INGO/1284,7715,12706,12253,12253,44927,7715,12706,12253,12706,45380
21,Somalia,2,2012,SOM-12/DMA-0489/SA  1/Nut/NGO/1288,0,1874,3400,3400,8674,0,950,1700,1770,4420
21,Somalia,2,2012,SOM-12/DMA-0489/SA  1/WASH/NGO/1289,21000,31500,9000,9000,70500,21000,31500,9000,13500,75000
21,Somalia,2,2012,SOM-12/DMA-0489/SA  1/Shelter/INGO/1292,3852,5778,3852,3852,17334,2725,4088,2725,4089,13627
21,Somalia,2,2012,SOM-12/DMA-0489/SA  1/WASH/INGO/1297,7155,8745,0,0,15900,0,0,0,0,0
21,Somalia,2,2012,SOM-12/DMA-0489/SA  1/Prot/INGO/1298,3107,4950,2542,2542,13141,1345,1528,1090,1195,5158
21,Somalia,2,2012,SOM-12/DMA-0489/SA  1/Nut/UN/1300,0,0,7125,7125,14250,0,0,0,0,0
21,Somalia,2,2012,SOM-12/DMA-0489/SA  1/H/INGO/1307,40460,38874,24179,24179,127692,11812,14466,20582,24162,71022
21,Somalia,2,2012,SOM-12/DMA-0489/SA  1/WASH/INGO/1310,40850,54150,0,0,95000,34509,37384,0,0,71893
21,Somalia,2,2012,SOM-12/DMA-0489/SA  1/WASH/INGO/1314,7248,7852,14496,14496,44092,5760,6240,11520,12480,36000
21,Somalia,2,2012,SOM-12/DMA-0489/SA  1/H/UN/1315,1174680,1320260,7000,7000,2508940,822000,924000,3232,4956,1754188
21,Somalia,1,2012,SOM-12/DMA-0489/ER /FSC/INGO/1317,5800,5800,8700,8700,29000,2526,11066,8736,8157,30485
21,Somalia,1,2012,SOM-12/DMA-0489/ER /WASH/NGO/1321,19311,28965,0,0,48276,19311,28965,0,0,48276
21,Somalia,2,2012,SOM-12/DMA-0489/SA  1/EP/UN/1325,0,0,0,0,0,1402,0,0,0,1402
21,Somalia,1,2012,SOM-12/DMA-0489/ER /L/UN/1328,0,0,0,0,0,0,0,0,0,0
21,Somalia,2,2012,SOM-12/DMA-0489/SA  1/EP/UN/1329,0,0,0,0,0,25,20,0,0,45
21,Somalia,2,2012,SOM-12/DMA-0489/SA  1/EP/UN/1330,130,130,0,0,260,120,40,0,0,160
21,Somalia,1,2012,SOM-12/DMA-0489/ER /WASH/NGO/1332,6650,19500,8500,8500,43150,6650,19500,8500,9500,44150
21,Somalia,1,2012,SOM-12/DMA-0489/ER /Nut/NGO/1352,0,3500,4100,4100,11700,0,1760,1900,2500,6160
21,Somalia,1,2012,SOM-12/DMA-0489/ER /Nut/INGO/1356,17,1543,1025,1025,3610,17,871,613,655,2156
21,Somalia,1,2012,SOM-12/DMA-0489/ER /WASH/INGO/1423,42000,42000,0,0,84000,44100,53900,0,0,98000
21,Somalia,1,2012,SOM-12/DMA-0489/ER /FSC/INGO/1446,3000,4000,8750,8750,24500,6077,5513,11053,9735,32378
21,Somalia,1,2012,SOM-12/DMA-0489/ER /WASH/INGO/1448,4480,6720,1120,1120,13440,4480,6720,1120,1680,14000
21,Somalia,1,2012,SOM-12/DMA-0489/ER /WASH/INGO/1453,1318,3130,2212,2212,8872,1068,2960,2010,2162,8200
21,Somalia,2,2012,SOM-12/DMA-0489/SA  2/FSC/NGO/1456,1386,2079,2703,2703,8871,1386,2079,2703,3732,9900
21,Somalia,2,2012,SOM-12/DMA-0489/SA  2/H/UN/1460,60144,79252,16000,16000,171396,40088,52687,10700,10700,114175
21,Somalia,2,2012,SOM-12/DMA-0489/SA  2/H/INGO/1461,11885,65370,23771,23771,124797,7803,36532,21686,21361,87382
21,Somalia,2,2012,SOM-12/DMA-0489/SA  2/WASH/INGO/1462,6576,6844,5380,5380,24180,456,474,135,135,1200
21,Somalia,2,2012,SOM-12/DMA-0489/SA  2/FSC/INGO/1463,3780,1620,0,0,5400,3774,1626,0,0,5400
21,Somalia,2,2012,SOM-12/DMA-0489/SA  2/Prot/NGO/1468,1017,1066,800,800,3683,503,709,420,300,1932
21,Somalia,2,2012,SOM-12/DMA-0489/SA  2/FSC/NGO/1473,1010,1100,2160,2160,6430,1010,1100,2160,2160,6430
21,Somalia,2,2012,SOM-12/DMA-0489/SA  2/Nut/NGO/1474,50,1444,2051,2051,5596,20,556,807,1002,2385
21,Somalia,2,2012,SOM-12/DMA-0489/SA  2/Nut/NGO/1476,27,2528,5970,5970,14495,27,886,904,904,2721
21,Somalia,2,2012,SOM-12/DMA-0489/SA  2/WASH/NGO/1477,12247,13267,13268,13268,52050,9400,10259,9254,10482,39395
21,Somalia,2,2012,SOM-12/DMA-0489/SA  2/EP/INGO/1486,3000000,3000000,0,0,6000000,3000000,3000000,0,0,6000000
21,Somalia,2,2012,SOM-12/DMA-0489/SA  2/Nut/UN/1487,0,0,22100,22100,44200,0,0,14266,13706,27972
21,Somalia,2,2012,SOM-12/DMA-0489/SA  2/Nut/NGO/1490,325,440,490,490,1745,325,440,490,545,1800
21,Somalia,2,2012,SOM-12/DMA-0489/SA  2/EP/UN/1495,225000,225000,225000,225000,900000,225000,225000,225000,225000,900000
21,Somalia,2,2012,SOM-12/DMA-0489/SA  2/EP/INGO/1496,0,0,0,0,0,0,91,0,0,91
21,Somalia,2,2012,SOM-12/DMA-0489/SA  2/FSC/INGO/1497,26385,20565,0,0,46950,20913,16432,0,0,37345
21,Somalia,2,2012,SOM-12/DMA-0489/SA  2/Nut/NGO/1498,0,600,600,600,1800,0,346,297,415,1058
21,Somalia,2,2012,SOM-12/DMA-0489/SA  2/Nut/INGO/1504,0,5662,6292,6292,18246,0,4530,5030,5037,14597
21,Somalia,2,2012,SOM-12/DMA-0489/SA  2/FSC/NGO/1505,1880,2080,3300,3300,10560,1880,2080,3300,3300,10560
21,Somalia,2,2012,SOM-12/DMA-0489/SA  2/FSC/NGO/1507,838,1257,838,838,3771,915,1295,724,876,3810
21,Somalia,2,2012,SOM-12/DMA-0489/SA  2/Shelter/UN/1509,150,150,300,300,900,150,150,300,300,900
21,Somalia,2,2012,SOM-12/DMA-0489/SA  2/FSC/INGO/1512,3526,3151,2830,2830,12337,1446,538,4960,4960,11904
21,Somalia,2,2012,SOM-12/DMA-0489/SA  2/FSC/NGO/1513,1684,1810,1223,1223,5940,556,602,1223,1223,3604
21,Somalia,2,2012,SOM-12/DMA-0489/SA  2/WASH/INGO/1520,3831,4864,2310,2310,13315,1114,2053,1052,1714,5933
21,Somalia,2,2012,SOM-12/DMA-0489/SA  2/FSC/NGO/1526,1889,2519,2308,2308,9024,1889,2519,2308,3778,10494
21,Somalia,2,2012,SOM-12/DMA-0489/SA  2/Ed/NGO/1527,195,220,2200,2200,4815,195,220,1865,1105,3385
21,Somalia,2,2012,SOM-12/DMA-0489/SA  2/Prot/INGO/1529,22147,24532,10015,10015,66709,3,179,0,16,198
21,Somalia,2,2012,SOM-12/DMA-0489/SA  2/H/INGO/1531,4158,5742,3564,4536,18000,2899,5728,1861,1502,11990
21,Somalia,2,2012,SOM-12/DMA-0489/SA  2/Ed/INGO/1539,67,26,1045,1045,2183,53,25,842,600,1520
21,Somalia,2,2012,SOM-12/DMA-0489/SA  2/WASH/NGO/1544,4822,7232,4450,4450,20954,4822,7232,4450,6676,23180
21,Somalia,2,2012,SOM-12/DMA-0489/SA  2/H/INGO/1547,43218,44982,59682,59682,207564,11097,32370,8130,31649,83246
21,Somalia,2,2012,SOM-12/DMA-0489/SA  2/WASH/INGO/1550,17356,17178,13957,13957,62448,17860,17448,13978,13965,63251
21,Somalia,1,2012,SOM-12/DMA-0489/ER /FSC/UN/1551,12250,5250,0,0,17500,16986,5662,0,0,22648
21,Somalia,2,2012,SOM-12/DMA-0489/SA  2/WASH/INGO/1556,6891,7147,5615,5615,25268,2000,3000,2500,2500,10000
21,Somalia,2,2012,SOM-12/DMA-0489/SA  2/Nut/NGO/1558,0,997,1652,1652,4301,0,905,1516,1647,4068
21,Somalia,2,2012,SOM-12/DMA-0489/SA  2/FSC/NGO/1559,720,840,300,300,2160,367,434,184,185,1170
21,Somalia,2,2012,SOM-12/DMA-0489/SA  2/Ed/INGO/1568,18,12,2160,2160,4350,6,4,1728,1152,2890
21,Somalia,2,2012,SOM-12/DMA-0489/SA  2/Ed/INGO/1571,25,25,1200,1200,2450,30,20,1071,849,1970
21,Somalia,2,2012,SOM-12/DMA-0489/SA  2/Nut/NGO/1578,20,2495,2700,2700,7915,20,772,1230,1230,3252
21,Somalia,2,2012,SOM-12/DMA-0489/SA  2/Prot/INGO/1579,3930,6520,3216,3216,16882,500,800,0,100,1400
21,Somalia,2,2012,SOM-12/DMA-0489/SA  2/FSC/INGO/1580,2448,4032,3888,3888,14256,1950,2022,1228,2022,7222
21,Somalia,2,2012,SOM-12/DMA-0489/SA  2/EP/INGO/1582,0,0,0,0,0,196,142,0,0,338
21,Somalia,2,2012,SOM-12/DMA-0489/SA  2/Nut/NGO/1586,0,600,800,800,2200,0,300,0,400,700
21,Somalia,2,2012,SOM-12/DMA-0489/SA  2/Shelter/INGO/1590,2100,4200,2450,2450,11200,761,1186,888,693,3528
21,Somalia,2,2012,SOM-12/DMA-0489/SA  2/Nut/NGO/1594,115,957,964,964,3000,85,713,482,722,2002
21,Somalia,2,2012,SOM-12/DMA-0489/SA  2/FSC/NGO/1595,1753,2170,2003,2003,7929,1753,2170,2003,2540,8466
21,Somalia,2,2012,SOM-12/DMA-0489/SA  2/FSC/INGO/1599,792,1188,2310,2310,6600,512,400,1029,686,2627
21,Somalia,2,2012,SOM-12/DMA-0489/SA  2/FSC/INGO/1600,24,8,483,483,998,24,8,460,230,722
21,Somalia,2,2012,SOM-12/DMA-0489/SA  2/H/UN/1605,99960,104040,87000,87000,378000,50000,62000,44000,44000,200000
21,Somalia,2,2012,SOM-12/DMA-0489/SA  2/Prot/INGO/1613,2530,4620,1870,1870,10890,2500,2500,984,756,6740
21,Somalia,2,2012,SOM-12/DMA-0489/SA  2/Prot/INGO/1614,70,70,1400,1400,2940,176,154,1383,1976,3689
21,Somalia,2,2012,SOM-12/DMA-0489/SA  2/FSC/NGO/1615,604,738,3020,3020,7382,0,0,0,0,0
21,Somalia,2,2012,SOM-12/DMA-0489/SA  2/FSC/UN/1616,744,744,3717,3717,8922,872,1235,4670,5865,12642
21,Somalia,2,2012,SOM-12/DMA-0489/SA  2/Ed/INGO/1620,4207,6325,788,788,12108,80,18,120,120,338
21,Somalia,2,2012,SOM-12/DMA-0489/SA  2/FSC/INGO/1621,1223,2271,6114,6114,15722,1035,1552,5174,7761,15522
21,Somalia,2,2012,SOM-12/DMA-0489/SA  2/FSC/INGO/1623,1100,1100,2200,2200,6600,0,0,0,0,0
21,Somalia,2,2012,SOM-12/DMA-0489/SA  2/H/UN/1624,199878,309276,0,0,509154,15682,16323,0,0,32005
21,Somalia,2,2012,SOM-12/DMA-0489/SA  2/Nut/INGO/1628,0,1012,2206,2206,5424,0,405,820,882,2107
21,Somalia,2,2012,SOM-12/DMA-0489/SA  2/WASH/UN/1630,38566,45350,0,0,83916,3429,4191,0,0,7620
21,Somalia,2,2012,SOM-12/DMA-0489/SA  2/WASH/NGO/1632,5720,5917,9350,9350,30337,5720,5917,9350,9350,30337
21,Somalia,2,2012,SOM-12/DMA-0489/SA  2/Nut/INGO/1633,300,4698,3097,3097,11192,111,1083,10,20,1224
21,Somalia,2,2012,SOM-12/DMA-0489/SA  2/FSC/NGO/1637,2339,2533,2533,2533,9938,2339,2533,2533,2533,9938
21,Somalia,2,2012,SOM-12/DMA-0489/SA  2/Nut/INGO/1639,30,1870,2150,2150,6200,30,745,1967,2974,5716
21,Somalia,2,2012,SOM-12/DMA-0489/SA  2/WASH/NGO/1642,11232,13728,18720,18720,62400,2718,3322,4530,4530,15100
21,Somalia,2,2012,SOM-12/DMA-0489/SA  2/H/NGO/1643,14000,16000,18465,18465,66930,5900,3200,10050,12560,31710
21,Somalia,2,2012,SOM-12/DMA-0489/SA  2/FSC/INGO/1644,3360,5040,840,840,10080,2406,2564,3677,3772,12419
21,Somalia,2,2012,SOM-12/DMA-0489/SA  2/Ed/INGO/1647,101,101,1675,1675,3552,101,101,1675,1675,3552
21,Somalia,2,2012,SOM-12/DMA-0489/SA  2/FSC/INGO/1650,466,444,350,350,1610,355,1097,213,658,2323
21,Somalia,2,2012,SOM-12/DMA-0489/SA  2/WASH/INGO/1655,5100,8400,8100,8100,29700,5100,8400,8100,8400,30000
21,Somalia,2,2012,SOM-12/DMA-0489/SA  2/WASH/UN/1656,250000,250000,250000,250000,1000000,250000,250000,250000,250000,1000000
21,Somalia,2,2012,SOM-12/DMA-0489/SA  2/Shelter/INGO/1657,45,302,604,604,1555,45,302,604,906,1857
21,Somalia,2,2012,SOM-12/DMA-0489/SA  2/FSC/NGO/1659,710,250,130,130,1220,700,250,120,130,1200
21,Somalia,2,2012,SOM-12/DMA-0489/SA  2/FSC/NGO/1662,1687,2089,1928,1928,7632,1755,2115,1886,2356,8112
21,Somalia,2,2012,SOM-12/DMA-0489/SA  2/Ed/INGO/1667,225,339,3118,3118,6800,137,26,1867,2490,4520
21,Somalia,2,2012,SOM-12/DMA-0489/SA  2/Shelter/INGO/1682,3516,3516,5098,5098,17228,2951,3441,3227,5162,14781
21,Somalia,2,2012,SOM-12/DMA-0489/SA  2/Nut/NGO/1692,81,3581,4450,4450,12562,41,1790,2225,2230,6286
21,Somalia,2,2012,SOM-12/DMA-0489/SA  2/Shelter/INGO/1693,945,983,2697,2697,7322,0,0,0,0,0
21,Somalia,2,2012,SOM-12/DMA-0489/SA  2/Nut/INGO/1697,2281,10054,3890,3890,20115,3098,8267,3098,4235,18698
21,Somalia,2,2012,SOM-12/DMA-0489/SA  2/FSC/INGO/1701,960,1040,1920,1920,5840,0,0,0,0,0
21,Somalia,2,2012,SOM-12/DMA-0489/SA  2/Nut/NGO/1702,85,4129,1966,1966,8146,90,1090,490,447,2117
21,Somalia,2,2012,SOM-12/DMA-0489/SA  2/Nut/NGO/1704,600,600,500,500,2200,412,516,0,0,928
21,Somalia,2,2012,SOM-12/DMA-0489/SA  2/EP/UN/1705,0,0,0,0,0,0,0,0,0,0
21,Somalia,2,2012,SOM-12/DMA-0489/SA  2/Nut/UN/1709,0,4700,45965,45965,96630,0,28157,63607,54809,146573
21,Somalia,2,2012,SOM-12/DMA-0489/SA  2/EP/UN/1731,700,700,0,0,1400,700,700,0,0,1400
21,Somalia,1,2012,SOM-12/DMA-0489/ER /L/UN/1780,1000,1000,0,0,2000,0,0,0,0,0
21,Somalia,1,2012,SOM-12/DMA-0489/ER /H/INGO/1790,2000,3000,2500,2800,10300,2343,4147,2556,2686,11732
21,Somalia,2,2013,SOM-13/DMA-0489/SA  1/WASH/INGO/1797/35,3224,3356,3636,3784,14000,909,927,1680,1645,5161
21,Somalia,2,2013,SOM-13/DMA-0489/SA  1/FSC/INGO/1798/6,1170,1830,250,350,3600,585,915,140,190,1830
21,Somalia,2,2013,SOM-13/DMA-0489/SA  1/Nut/INGO/1799/60,30,1940,3510,3850,9330,30,3750,7037,13432,24249
21,Somalia,2,2013,SOM-13/DMA-0489/SA  1/Ed/NGO/1800/11,176,228,1300,1500,3204,183,221,1321,1479,3204
21,Somalia,2,2013,SOM-13/DMA-0489/SA  1/H/INGO/1801/43,30000,70000,12500,12500,125000,13400,31210,4800,5100,54510
21,Somalia,2,2013,SOM-13/DMA-0489/SA  1/Nut/NGO/1804/52,25,1070,1290,1570,3955,25,660,780,995,2460
21,Somalia,2,2013,SOM-13/DMA-0489/SA  1/WASH/NGO/1809/42,378,529,1343,3264,5514,378,529,1343,3264,5514
21,Somalia,2,2013,SOM-13/DMA-0489/SA  1/FSC/INGO/1821/7,560,840,1400,1400,4200,560,840,1400,1400,4200
21,Somalia,2,2013,SOM-13/DMA-0489/SA  1/H/NGO/1829/44,3500,11000,9300,13000,36800,1685,4379,4105,5120,15289
21,Somalia,2,2013,SOM-13/DMA-0489/SA  1/FSC/UN/1831,1350,1350,1350,1350,5400,465,465,465,464,1859
21,Somalia,2,2013,SOM-13/DMA-0489/SA  1/Nut/NGO/1832/61,360,1100,2200,2700,6360,170,510,435,590,1705
21,Somalia,2,2013,SOM-13/DMA-0489/SA  1/FSC/NGO/1841/5,11040,11630,2760,2840,28270,11040,11630,2760,2840,28270
21,Somalia,2,2013,SOM-13/DMA-0489/SA  1/Shelter/INGO/1846/32,200,400,600,600,1800,275,302,601,706,1884
21,Somalia,2,2013,SOM-13/DMA-0489/SA  1/FSC/INGO/1853/1,210,443,1306,1959,3918,304,401,1520,2005,4230
21,Somalia,2,2013,SOM-13/DMA-0489/SA  1/Nut/UN/1857,100,100,7825,7825,15850,0,0,0,0,0
21,Somalia,2,2013,SOM-13/DMA-0489/SA  1/Ed/NGO/1861/16,256,250,2600,2600,5706,256,250,1612,1612,3730
21,Somalia,2,2013,SOM-13/DMA-0489/SA  1/WASH/INGO/1862/37,7322,9900,9662,12254,39138,290,320,690,545,1845
21,Somalia,2,2013,SOM-13/DMA-0489/SA  1/Prot/NGO/1867/25,1225,2392,1400,1236,6253,620,1037,655,638,2950
21,Somalia,2,2013,SOM-13/DMA-0489/SA  1/Nut/NGO/1875/59,0,1700,3000,3000,7700,0,876,1563,1489,3928
21,Somalia,2,2013,SOM-13/DMA-0489/SA  1/Nut/NGO/1876/57,817,1384,2255,1845,6301,428,709,1152,933,3222
21,Somalia,2,2013,SOM-13/DMA-0489/SA  1/Nut/INGO/1878/50,310,3090,1668,2500,7568,0,1410,2258,3388,7056
21,Somalia,2,2013,SOM-13/DMA-0489/SA  1/Ed/INGO/1882/14,80,66,1050,1250,2446,80,47,615,925,1667
21,Somalia,2,2013,SOM-13/DMA-0489/SA  1/FSC/NGO/1883/8,915,1220,1275,1480,4890,915,1220,1275,1480,4890
21,Somalia,2,2013,SOM-13/DMA-0489/SA  1/Nut/INGO/1889/53,919,3840,3694,3275,11728,470,3097,1177,934,5678
21,Somalia,2,2013,SOM-13/DMA-0489/SA  1/Nut/NGO/1890/51,24,2664,1950,1950,6588,24,1543,1119,779,3465
21,Somalia,2,2013,SOM-13/DMA-0489/SA  1/EP/INGO/1891/49,2987,3249,0,0,6236,2327,715,0,0,3042
21,Somalia,2,2013,SOM-13/DMA-0489/SA  1/WASH/UN/1895,1800,2400,3600,4200,12000,270,360,540,630,1800
21,Somalia,2,2013,SOM-13/DMA-0489/SA  1/H/UN/1897,420,222353,96501,96501,415775,0,208062,115679,115679,439420
21,Somalia,2,2013,SOM-13/DMA-0489/SA  1/WASH/NGO/1899/41,5000,7100,5000,8100,25200,2000,4100,4000,5500,15600
21,Somalia,2,2013,SOM-13/DMA-0489/SA  1/H/UN/1908,26950,28050,22055,22950,100005,26950,28050,22055,22950,100005
21,Somalia,2,2013,SOM-13/DMA-0489/SA  1/H/UN/1910,0,16914,0,0,16914,4200,5350,0,0,9550
21,Somalia,2,2013,SOM-13/DMA-0489/SA  1/FSC/UN/1911,544,1634,544,1634,4356,264,679,1056,2717,4716
21,Somalia,2,2013,SOM-13/DMA-0489/SA  1/Shelter/NGO/1913/30,255,816,765,3264,5100,166,530,497,2122,3315
21,Somalia,2,2013,SOM-13/DMA-0489/SA  1/WASH/INGO/1917/33,8844,9204,4974,5178,28200,3538,3682,1990,2071,11281
21,Somalia,2,2013,SOM-13/DMA-0489/SA  1/WASH/NGO/1918/34,2638,4010,453,758,7859,1300,2000,200,320,3820
21,Somalia,2,2013,SOM-13/DMA-0489/SA  1/Prot/INGO/1921/19,94,1764,66,479,2403,37,759,17,156,969
21,Somalia,2,2013,SOM-13/DMA-0489/SA  1/FSC/NGO/1926/9,1024,1147,5120,5735,13026,942,1062,4710,5310,12024
21,Somalia,2,2013,SOM-13/DMA-0489/SA  1/Nut/INGO/1927/55,710,5086,1646,1646,9088,0,924,693,593,2210
21,Somalia,2,2013,SOM-13/DMA-0489/SA  1/Ed/INGO/1929/10,71,26,1033,1525,2655,71,26,878,933,1908
21,Somalia,2,2013,SOM-13/DMA-0489/SA  1/FSC/NGO/1941/4,800,900,440,500,2640,0,800,0,400,1200
21,Somalia,2,2013,SOM-13/DMA-0489/SA  1/Nut/NGO/1944/62,11,1859,400,400,2670,11,986,214,227,1438
21,Somalia,2,2013,SOM-13/DMA-0489/SA  1/Prot/INGO/1945/23,330,334,40,154,858,290,428,16,52,786
21,Somalia,2,2013,SOM-13/DMA-0489/SA  1/WASH/NGO/1947/39,2700,3300,4500,4500,15000,1350,1650,2250,2250,7500
21,Somalia,2,2013,SOM-13/DMA-0489/SA  1/Nut/NGO/1948/56,50,50,400,400,900,35,39,0,0,74
21,Somalia,2,2013,SOM-13/DMA-0489/SA  1/WASH/UN/1950,21000,24000,6750,8250,60000,43000,50000,13950,17050,124000
21,Somalia,2,2013,SOM-13/DMA-0489/SA  1/WASH/NGO/1951/64,1000,1400,3500,5500,11400,500,700,1750,2750,5700
21,Somalia,2,2013,SOM-13/DMA-0489/SA  1/H/UN/1962,3075,4525,3500,4000,15100,3680,7301,4218,4269,19468
21,Somalia,2,2013,SOM-13/DMA-0489/SA  1/EP/INGO/1963/48,1162,1421,1743,2131,6457,0,0,0,0,0
21,Somalia,2,2013,SOM-13/DMA-0489/SA  1/Prot/INGO/1964/18,131,411,946,1482,2970,295,489,397,327,1508
21,Somalia,2,2013,SOM-13/DMA-0489/SA  1/Prot/INGO/1968/20,1421,1479,784,816,4500,212,145,55,53,465
21,Somalia,2,2013,SOM-13/DMA-0489/SA  1/WASH/INGO/1969/38,6102,6610,2326,1996,17034,3487,3777,1329,1141,9734
21,Somalia,2,2013,SOM-13/DMA-0489/SA  1/FSC/INGO/1970/2,1643,2465,4108,4108,12324,1361,2041,3402,3402,10206
21,Somalia,2,2013,SOM-13/DMA-0489/SA  1/FSC/INGO/1971/0,1278,2100,2022,2100,7500,1201,1980,1910,1980,7071
21,Somalia,2,2013,SOM-13/DMA-0489/SA  1/WASH/NGO/1972/40,2048,2504,3415,3415,11382,2048,2504,3415,3415,11382
21,Somalia,2,2013,SOM-13/DMA-0489/SA  1/Shelter/INGO/1980/29,624,936,936,1404,3900,457,499,1259,1167,3382
21,Somalia,2,2013,SOM-13/DMA-0489/SA  1/H/INGO/1991/47,2057,3036,2500,2800,10393,732,1677,932,1042,4383
21,Somalia,2,2013,SOM-13/DMA-0489/SA  1/Prot/INGO/2005/22,1110,1332,1665,1443,5550,508,1026,1028,980,3542
21,Somalia,2,2013,SOM-13/DMA-0489/SA  1/Nut/NGO/2007/58,50,1938,970,970,3928,50,873,388,437,1748
21,Somalia,2,2013,SOM-13/DMA-0489/SA  1/FSC/NGO/2009/3,8101,12767,3455,4567,28890,338,432,0,0,770
21,Somalia,2,2013,SOM-13/DMA-0489/SA  1/Nut/NGO/2015/54,40,1354,760,760,2914,20,677,380,380,1457
21,Somalia,2,2013,SOM-13/DMA-0489/SA  1/Ed/INGO/2017/12,280,280,620,480,1660,41,46,473,456,1016
21,Somalia,2,2013,SOM-13/DMA-0489/SA  1/Ed/INGO/2023/15,32,20,600,600,1252,31,21,337,332,721
21,Somalia,2,2013,SOM-13/DMA-0489/SA  1/H/INGO/2024/46,11797,21908,30045,32549,96299,5247,6415,5722,6996,24380
21,Somalia,2,2013,SOM-13/DMA-0489/SA  1/Shelter/INGO/2025/27,1300,1560,1950,1690,6500,506,1029,1739,1539,4813
21,Somalia,2,2013,SOM-13/DMA-0489/SA  1/Nut/UN/2026,0,3000,26900,26900,56800,0,3000,26900,26900,56800
21,Somalia,2,2013,SOM-13/DMA-0489/SA  1/FSC/UN/2030,600,600,600,600,2400,100,300,0,0,400
21,Somalia,2,2013,SOM-13/DMA-0489/SA  1/Prot/INGO/2031/17,3360,5040,1440,2160,12000,1090,3500,305,897,5792
21,Somalia,2,2013,SOM-13/DMA-0489/SA  1/H/NGO/2032/63,9983,11719,6474,6683,34859,4967,10926,3841,3925,23659
21,Somalia,2,2013,SOM-13/DMA-0489/SA  1/Shelter/INGO/2035/26,4116,4284,1764,1836,12000,1720,1720,3440,3440,10320
21,Somalia,2,2013,SOM-13/DMA-0489/SA  1/Shelter/UN/2036,360,540,0,0,900,0,0,0,0,0
21,Somalia,2,2013,SOM-13/DMA-0489/SA  1/WASH/INGO/2037/36,1583,3133,2141,3295,10152,12,4,0,0,16
21,Somalia,2,2013,SOM-13/DMA-0489/SA  1/H/INGO/2040/45,18139,18879,3716,3866,44600,3533,5232,720,1067,10552
21,Somalia,2,2013,SOM-13/DMA-0489/SA  1/Prot/INGO/2050/24,135,75,1012,863,2085,53,35,173,147,408
21,Somalia,2,2013,SOM-13/DMA-0489/SA  1/Shelter/INGO/2054/31,17000,17000,33000,33000,100000,3400,3400,6600,6600,20000
21,Somalia,2,2013,SOM-13/DMA-0489/SA  1/Shelter/INGO/2055/28,900,2100,6000,9000,18000,1261,2233,1615,1994,7103
21,Somalia,1,2013,SOM-13/DMA-0489/ER /Ed/NGO/2061/67,44,43,765,765,1617,464,43,401,258,1166
21,Somalia,1,2013,SOM-13/DMA-0489/ER /FSC/INGO/2063/66,560,840,1400,1400,4200,560,840,1400,1400,4200
21,Somalia,2,2013,SOM-13/DMA-0489/SA  1/EP/INGO/2064/65,1372,2058,2058,3087,8575,1033,1549,1550,2324,6456
21,Somalia,1,2013,SOM-13/DMA-0489/ER /Nut/INGO/2066/73,0,1290,540,750,2580,0,0,0,0,0
21,Somalia,1,2013,SOM-13/DMA-0489/ER /Nut/INGO/2067/70,20,1985,350,350,2705,9,171,79,72,331
21,Somalia,1,2013,SOM-13/DMA-0489/ER /H/INGO/2068/68,4986,19944,33240,33240,91410,2002,8411,14540,15980,40933
21,Somalia,1,2013,SOM-13/DMA-0489/ER /H/INGO/2069/79,0,2133,3413,5119,10665,0,2844,2664,2329,7837
21,Somalia,1,2013,SOM-13/DMA-0489/ER /H/INGO/2070/74,7404,11105,925,1388,20822,52,356,333,368,1109
21,Somalia,1,2013,SOM-13/DMA-0489/ER /H/INGO/2071/75,600,600,465,465,2130,280,243,402,271,1196
21,Somalia,1,2013,SOM-13/DMA-0489/ER /H/NGO/2072/69,20089,20089,4911,4911,50000,0,0,0,0,0
21,Somalia,1,2013,SOM-13/DMA-0489/ER /H/INGO/2074/71,2357,4315,3964,6752,17388,428,700,1220,1992,4340
21,Somalia,1,2013,SOM-13/DMA-0489/ER /H/INGO/2076/76,38528,49536,16512,33024,137600,5105,6403,2403,4269,18180
21,Somalia,1,2013,SOM-13/DMA-0489/ER /H/INGO/2079/78,23897,35840,15590,24210,99537,6839,7194,5936,5648,25617
21,Somalia,1,2013,SOM-13/DMA-0489/ER /WASH/NGO/2080/77,800,5040,4000,9360,19200,500,4912,2938,8769,17119
21,Somalia,1,2013,SOM-13/DMA-0489/ER /H/UN/2081,0,502370,218422,218422,939214,0,565064,285145,285145,1135354
21,Somalia,2,2014,SOM-14/DMA-0489/SA  1/EP/INGO/2086/95,2500000,2500000,500000,500000,6000000,2500000,2500000,500000,500000,6000000
21,Somalia,2,2014,SOM-14/DMA-0489/SA  1/H/UN/2088,20060,90050,3000,3000,116110,0,0,0,0,0
21,Somalia,2,2014,SOM-14/DMA-0489/SA  1/WASH/UN/2092,6600,8800,13200,15400,44000,500,650,150,130,1430
21,Somalia,2,2014,SOM-14/DMA-0489/SA  1/H/INGO/2098/99,49360,116240,20000,21400,207000,19141,44192,6957,7341,77631
21,Somalia,2,2014,SOM-14/DMA-0489/SA  1/H/UN/2103,126,7186,0,0,7312,13,10371,5,5,10394
21,Somalia,2,2014,SOM-14/DMA-0489/SA  1/H/UN/2107,11000,20000,8600,9800,49400,8952,12269,4033,5740,30994
21,Somalia,2,2014,SOM-14/DMA-0489/SA  1/FSC/UN/2111,199,211,377,413,1200,150,468,150,468,1236
21,Somalia,2,2014,SOM-14/DMA-0489/SA  1/Nut/UN/2112,0,3000,5000,5000,13000,0,1500,2500,2500,6500
21,Somalia,2,2014,SOM-14/DMA-0489/SA  1/H/INGO/2116/80,31050,76950,13500,13500,135000,6270,7564,5345,5173,24352
21,Somalia,2,2014,SOM-14/DMA-0489/SA  1/WASH/INGO/2120/104,2547,2466,1994,1994,9001,0,0,0,0,0
21,Somalia,2,2014,SOM-14/DMA-0489/SA  1/Prot/INGO/2122/120,1678,2021,661,924,5284,147,399,194,214,954
21,Somalia,2,2014,SOM-14/DMA-0489/SA  1/Prot/INGO/2123/115,560,642,115,115,1432,807,1299,163,337,2606
21,Somalia,2,2014,SOM-14/DMA-0489/SA  1/H/INGO/2124/81,12039,22040,5419,5419,44917,6160,6528,1403,1797,15888
21,Somalia,2,2014,SOM-14/DMA-0489/SA  1/Nut/NGO/2134/91,0,2540,1871,1871,6282,0,1270,935,936,3141
21,Somalia,2,2014,SOM-14/DMA-0489/SA  1/Prot/INGO/2135/116,190,390,250,300,1130,117,346,191,198,852
21,Somalia,2,2014,SOM-14/DMA-0489/SA  1/Shelter/INGO/2136/98,3528,3672,5292,5508,18000,2979,2400,2700,3300,11379
21,Somalia,2,2014,SOM-14/DMA-0489/SA  1/Prot/INGO/2138/83,4480,6720,1920,2880,16000,1209,1911,513,578,4211
21,Somalia,2,2014,SOM-14/DMA-0489/SA  1/WASH/INGO/2140/87,4435,7305,7044,7304,26088,430,708,683,709,2530
21,Somalia,2,2014,SOM-14/DMA-0489/SA  1/Ed/INGO/2142/117,170,73,563,563,1369,51,56,2339,2307,4753
21,Somalia,2,2014,SOM-14/DMA-0489/SA  1/H/INGO/2144/85,0,43008,7128,28944,79080,11685,22910,7709,12470,54774
21,Somalia,2,2014,SOM-14/DMA-0489/SA  1/WASH/NGO/2145/94,2790,3410,4650,4650,15500,2504,3060,4173,4173,13910
21,Somalia,2,2014,SOM-14/DMA-0489/SA  1/Nut/INGO/2146/109,898,6208,2450,2450,12006,0,0,0,0,0
21,Somalia,2,2014,SOM-14/DMA-0489/SA  1/Nut/NGO/2152/90,0,1200,400,400,2000,0,402,133,130,665
21,Somalia,2,2014,SOM-14/DMA-0489/SA  1/Ed/INGO/2158/86,70,71,1102,1523,2766,50,42,475,497,1064
21,Somalia,2,2014,SOM-14/DMA-0489/SA  1/H/INGO/2161/100,10600,10600,465,465,22130,2179,5124,175,201,7679
21,Somalia,2,2014,SOM-14/DMA-0489/SA  1/WASH/INGO/2162/92,11520,12480,12480,13520,50000,5760,6240,6240,6760,25000
21,Somalia,2,2014,SOM-14/DMA-0489/SA  1/Nut/NGO/2163/88,128,510,720,720,2078,48,220,255,262,785
21,Somalia,2,2014,SOM-14/DMA-0489/SA  1/H/UN/2165,113219,117841,92634,96415,420109,113219,117841,92634,96415,420109
21,Somalia,2,2014,SOM-14/DMA-0489/SA  1/Nut/NGO/2166/89,0,827,1476,1476,3779,0,328,347,349,1024
21,Somalia,2,2014,SOM-14/DMA-0489/SA  1/Ed/INGO/2167/96,39,21,1380,925,2365,38,22,604,435,1099
21,Somalia,2,2014,SOM-14/DMA-0489/SA  1/Nut/INGO/2169/101,0,0,360,360,720,0,0,85,117,202
21,Somalia,2,2014,SOM-14/DMA-0489/SA  1/H/NGO/2170/97,1500,4999,5174,5174,16847,508,2788,1750,2457,7503
21,Somalia,2,2014,SOM-14/DMA-0489/SA  1/Nut/NGO/2174/84,30,1140,1400,1600,4170,30,570,700,800,2100
21,Somalia,2,2014,SOM-14/DMA-0489/SA  1/FSC/INGO/2175/124,96,432,192,240,960,16,64,0,0,80
21,Somalia,2,2014,SOM-14/DMA-0489/SA  1/FSC/INGO/2177/82,1326,2184,2106,2184,7800,1293,2130,2053,2130,7606
21,Somalia,2,2014,SOM-14/DMA-0489/SA  1/Nut/INGO/2178/111,950,2232,298,322,3802,331,797,152,200,1480
21,Somalia,2,2014,SOM-14/DMA-0489/SA  1/FSC/UN/2179,1146,1146,1146,1146,4584,2100,2100,0,0,4200
21,Somalia,2,2014,SOM-14/DMA-0489/SA  1/FSC/INGO/2180/102,329,141,1175,1175,2820,0,0,0,0,0
21,Somalia,2,2014,SOM-14/DMA-0489/SA  1/FSC/INGO/2182/118,1926,2022,2842,3080,9870,240,240,0,0,480
21,Somalia,2,2014,SOM-14/DMA-0489/SA  1/FSC/INGO/2183/114,440,1008,640,1512,3600,515,986,1021,1305,3827
21,Somalia,2,2014,SOM-14/DMA-0489/SA  1/EP/UN/2185,3751327,3751327,0,0,7502654,3751327,3751327,0,0,7502654
21,Somalia,2,2014,SOM-14/DMA-0489/SA  1/EP/INGO/2189/107,0,0,0,0,0,0,0,0,0,0
21,Somalia,2,2014,SOM-14/DMA-0489/SA  1/MsR/INGO/2190/126,572,1061,3674,4491,9798,193,727,1045,1012,2977
21,Somalia,2,2014,SOM-14/DMA-0489/SA  1/EP/UN/2191,200000,200000,200000,200000,800000,200000,200000,200000,200000,800000
21,Somalia,2,2014,SOM-14/DMA-0489/SA  1/Nut/INGO/2194/106,5,1625,53,53,1736,4,2768,78,79,2929
21,Somalia,2,2014,SOM-14/DMA-0489/SA  1/MsR/INGO/2197/113,861,938,1017,1094,3910,351,555,1114,1020,3040
21,Somalia,2,2014,SOM-14/DMA-0489/SA  1/WASH/UN/2201,10000,10000,0,0,20000,0,0,0,0,0
21,Somalia,2,2014,SOM-14/DMA-0489/SA  1/FSC/INGO/2203/93,1799,2699,1801,2701,9000,2044,1883,2048,1885,7860
21,Somalia,2,2014,SOM-14/DMA-0489/SA  1/Nut/INGO/2204/103,60,60,0,0,120,77,43,0,0,120
21,Somalia,2,2014,SOM-14/DMA-0489/SA  1/Ed/INGO/2208/110,335,229,1500,1750,3814,174,90,1447,1757,3468
21,Somalia,2,2014,SOM-14/DMA-0489/SA  1/WASH/INGO/2210/108,5303,4872,10313,8712,29200,2678,2526,6050,5293,16547
21,Somalia,2,2014,SOM-14/DMA-0489/SA  1/FSC/UN/2220,914,914,1774,1774,5376,1487,1488,3471,3472,9918
21,Somalia,2,2014,SOM-14/DMA-0489/SA  1/MsR/INGO/2222/105,126,72,333,369,900,24,143,66,367,600
21,Somalia,2,2014,SOM-14/DMA-0489/SA  1/WASH/UN/2225,43200,52800,0,0,96000,0,0,0,0,0
21,Somalia,2,2014,SOM-14/DMA-0489/SA  1/Nut/UN/2226,0,0,4537,4360,8897,0,0,0,0,0
21,Somalia,1,2014,SOM-14/DMA-0489/ER /EP/UN/2227,600,800,0,0,1400,600,800,0,0,1400
21,Somalia,2,2014,SOM-14/DMA-0489/SA  1/EP/INGO/2230/112,0,0,0,0,0,0,0,0,0,0
21,Somalia,2,2014,SOM-14/DMA-0489/SA  1/Shelter/INGO/2231/121,4047,2982,7454,6815,21298,3230,3064,7003,6780,20077
21,Somalia,2,2014,SOM-14/DMA-0489/SA  1/Shelter/INGO/2235/119,3874,4650,3099,3874,15497,1792,2103,2190,2570,8655
21,Somalia,1,2014,SOM-14/DMA-0489/ER /H/INGO/2237/127,1278,2262,1395,1465,6400,865,1465,509,436,3275
21,Somalia,1,2014,SOM-14/DMA-0489/ER /WASH/INGO/2238/128,7419,8037,0,0,15456,9582,5874,0,0,15456
21,Somalia,1,2014,SOM-14/DMA-0489/ER /WASH/INGO/2239/122,2389,2588,3884,3583,12444,3702,3957,6408,6453,20520
21,Somalia,1,2014,SOM-14/DMA-0489/ER /WASH/INGO/2240/123,18001,19501,19501,21126,78129,18001,19501,19501,21126,78129
21,Somalia,1,2014,SOM-14/DMA-0489/ER /WASH/NGO/2241/125,17420,18845,4324,4711,45300,17580,19139,4444,4821,45984
21,Somalia,1,2014,SOM-14/DMA-0489/ER /H/UN/2242,260000,260000,260000,260000,1040000,0,0,299413,299414,598827
21,Somalia,1,2014,SOM-14/DDA-3485/ER /H/UN/2243,0,0,260000,260000,520000,0,0,324060,324060,648120
21,Somalia,1,2014,SOM-14/DDA-3485/ER /WASH/INGO/2244/129,1689,2111,2112,2533,8445,900,3348,792,1260,6300
21,Somalia,1,2014,SOM-14/DDA-3485/ER /EP/UN/2246,125,125,0,0,250,0,0,0,0,0
21,Somalia,1,2014,SOM-14/DDA-3485/ER /WASH/NGO/2247/130,6391,7291,13082,14282,41046,768,1034,1300,1400,4502
21,Somalia,2,2014,SOM-14/DDA-3485/SR /Ed/INGO/2248/136,246,145,0,0,391,289,102,7947,6992,15330
21,Somalia,2,2014,SOM-14/DDA-3485/SR /Ed/INGO/2249/137,142,37,4484,3235,7898,142,37,4484,3235,7898
21,Somalia,2,2014,SOM-14/DDA-3485/SR /Ed/NGO/2250/138,100,41,3700,3700,7541,105,36,2988,2624,5753
21,Somalia,2,2014,SOM-14/DDA-3485/SR /WASH/UN/2251,18144,22176,14256,17424,72000,12581,15376,9885,12081,49923
21,Somalia,2,2014,SOM-14/DDA-3485/SR /WASH/NGO/2253/164,13129,19693,12119,18179,63120,13219,19693,12119,18179,63210
21,Somalia,2,2014,SOM-14/DDA-3485/SR /WASH/INGO/2254/131,10588,12224,10707,12411,45930,6995,8743,8744,10492,34974
21,Somalia,2,2014,SOM-14/DDA-3485/SR /Nut/NGO/2255/142,0,600,400,600,1600,29,88,122,135,374
21,Somalia,2,2014,SOM-14/DDA-3485/SR /Nut/NGO/2256/141,10,2821,900,900,4631,10,981,450,450,1891
21,Somalia,2,2014,SOM-14/DDA-3485/SR /Nut/INGO/2257/140,53,2213,1350,1350,4966,28,1180,605,779,2592
21,Somalia,2,2014,SOM-14/DDA-3485/SR /Nut/NGO/2258/147,27,527,1255,1255,3064,27,304,603,577,1511
21,Somalia,2,2014,SOM-14/DDA-3485/SR /Nut/NGO/2259/156,15,1885,400,400,2700,12,918,200,200,1330
21,Somalia,2,2014,SOM-14/DDA-3485/SR /Nut/NGO/2260/155,0,800,600,800,2200,0,400,400,350,1150
21,Somalia,2,2014,SOM-14/DDA-3485/SR /Nut/INGO/2261/165,14240,21360,2458,2269,40327,4707,16560,1206,1207,23680
21,Somalia,2,2014,SOM-14/DDA-3485/SR /Nut/NGO/2262/154,0,1000,1200,1200,3400,0,570,590,660,1820
21,Somalia,2,2014,SOM-14/DDA-3485/SR /Nut/INGO/2263/151,20,2120,1400,1400,4940,20,1061,598,621,2300
21,Somalia,2,2014,SOM-14/DDA-3485/SR /Nut/NGO/2264/152,33,153,2434,3926,6546,19,120,519,1020,1678
21,Somalia,2,2014,SOM-14/DDA-3485/SR /Nut/UN/2265,0,2478,8807,8807,20092,0,8905,25591,25597,60093
21,Somalia,2,2014,SOM-14/DDA-3485/SR /Nut/UN/2266,0,0,5322,5112,10434,0,0,0,0,0
21,Somalia,2,2014,SOM-14/DDA-3485/SR /H/UN/2267,8075,11225,16200,19600,55100,4361,4811,2100,3264,14536
21,Somalia,2,2014,SOM-14/DDA-3485/SR /H/INGO/2268/145,18357,19107,4590,4776,46830,1869,1946,671,700,5186
21,Somalia,2,2014,SOM-14/DDA-3485/SR /H/INGO/2269/144,20600,40800,19470,18530,99400,8245,23167,9190,10850,51452
21,Somalia,2,2014,SOM-14/DDA-3485/SR /H/UN/2270,20,3875,0,0,3895,0,1235,0,0,1235
21,Somalia,2,2014,SOM-14/DDA-3485/SR /H/UN/2271,8580,7920,6480,7020,30000,3500,4500,3400,3600,15000
21,Somalia,2,2014,SOM-14/DDA-3485/SR /H/NGO/2272/143,7000,15000,6500,6500,35000,2050,3065,2150,2450,9715
21,Somalia,2,2014,SOM-14/DDA-3485/SR /H/UN/2273,0,0,0,0,0,0,0,0,0,0
21,Somalia,2,2014,SOM-14/DDA-3485/SR /H/UN/2274,14000,16000,4000,4000,38000,0,0,0,0,0
21,Somalia,2,2014,SOM-14/DDA-3485/SR /H/NGO/2276/146,9000,17000,7000,7000,40000,3672,4722,2448,3148,13990
21,Somalia,2,2014,SOM-14/DDA-3485/SR /FSC/INGO/2277/158,380,160,1350,1350,3240,120,60,0,0,180
21,Somalia,2,2014,SOM-14/DDA-3485/SR /FSC/INGO/2278/133,816,1344,1296,1344,4800,768,4032,0,0,4800
21,Somalia,2,2014,SOM-14/DDA-3485/SR /FSC/NGO/2279/149,6428,7347,11938,11019,36732,6428,7347,11938,11019,36732
21,Somalia,2,2014,SOM-14/DDA-3485/SR /FSC/UN/2280,106680,45720,0,0,152400,132169,56643,0,0,188812
21,Somalia,2,2014,SOM-14/DDA-3485/SR /FSC/INGO/2281/134,804,965,1045,1206,4020,804,965,1045,1206,4020
21,Somalia,2,2014,SOM-14/DDA-3485/SR /FSC/INGO/2282/157,600,900,3374,4126,9000,453,1047,3374,4126,9000
21,Somalia,2,2014,SOM-14/DDA-3485/SR /WASH/UN/2283,1625,2166,3249,3790,10830,700,1150,500,1000,3350
21,Somalia,2,2014,SOM-14/DDA-3485/SR /WASH/NGO/2284/162,4200,4900,2100,2800,14000,2145,2350,1232,1462,7189
21,Somalia,2,2014,SOM-14/DDA-3485/SR /WASH/INGO/2285/159,2098,3455,3332,3455,12340,230,378,364,378,1350
21,Somalia,2,2014,SOM-14/DDA-3485/SR /FSC/NGO/2286/139,510,517,830,1245,3102,510,517,830,1245,3102
21,Somalia,2,2014,SOM-14/DDA-3485/SR /FSC/NGO/2287/148,680,700,610,590,2580,680,700,610,590,2580
21,Somalia,2,2014,SOM-14/DDA-3485/SR /FSC/UN/2288,12516,12517,10241,10241,45515,2822,2938,2995,3245,12000
21,Somalia,2,2014,SOM-14/DDA-3485/SR /FSC/NGO/2289/150,900,1600,2400,2900,7800,0,0,0,0,0
21,Somalia,2,2014,SOM-14/DDA-3485/SR /Shelter/INGO/2290/171,607,820,1035,1108,3570,0,0,0,0,0
21,Somalia,2,2014,SOM-14/DDA-3485/SR /Shelter/UN/2291,24000,36000,0,0,60000,24000,36000,0,0,60000
21,Somalia,2,2014,SOM-14/DDA-3485/SR /Shelter/NGO/2292/163,509,594,255,340,1698,60,65,50,65,240
21,Somalia,2,2014,SOM-14/DDA-3485/SR /Shelter/INGO/2293/175,612,742,640,771,2765,612,742,640,771,2765
21,Somalia,2,2014,SOM-14/DDA-3485/SR /WASH/INGO/2294/169,3502,3644,2382,2382,11910,2500,2985,1986,1987,9458
21,Somalia,2,2014,SOM-14/DDA-3485/SR /WASH/NGO/2295/161,2634,3950,3657,4389,14630,2271,2776,2776,3392,11215
21,Somalia,2,2014,SOM-14/DDA-3485/SR /Prot/INGO/2296/135,188,439,439,1024,2090,90,150,80,200,520
21,Somalia,2,2014,SOM-14/DDA-3485/SR /Prot/NGO/2297/153,855,2638,5,47,3545,134,316,1,28,479
21,Somalia,2,2014,SOM-14/DDA-3485/SR /Prot/NGO/2298/170,202,458,450,450,1560,202,458,450,450,1560
21,Somalia,2,2014,SOM-14/DDA-3485/SR /Prot/INGO/2299/172,2346,2542,1613,2227,8728,162,201,0,9,372
21,Somalia,2,2014,SOM-14/DDA-3485/SR /WASH/NGO/2300/132,2566,3136,4276,4276,14254,1283,1568,2138,2139,7128
21,Somalia,2,2014,SOM-14/DDA-3485/SR /WASH/INGO/2301/168,1911,2340,1560,1989,7800,1544,1705,2333,2518,8100
21,Somalia,2,2014,SOM-14/DDA-3485/SR /WASH/INGO/2302/167,1230,1182,1845,1773,6030,0,0,0,0,0
21,Somalia,2,2014,SOM-14/DDA-3485/SR /WASH/INGO/2303/160,3015,3685,4411,5389,16500,1742,2218,2673,3267,9900
21,Somalia,1,2014,SOM-14/DDA-3485/ER /EP/UN/2305,250,250,0,0,500,0,0,0,0,0
21,Somalia,2,2014,SOM-14/DDA-3485/SR /WASH/NGO/2306/166,6336,5885,5185,7194,24600,2839,3697,4850,5216,16602
21,Somalia,2,2014,SOM-14/DDA-3485/SR /WASH/INGO/2307/174,6702,7554,5805,5805,25866,429,801,1022,913,3165
21,Somalia,1,2014,SOM-14/DDA-3485/ER /WASH/INGO/2310/173,16376,17044,11140,11140,55700,9245,9538,6856,6856,32495
21,Somalia,1,2014,SOM-14/DDA-3485/ER /FSC/UN/2311,66780,28620,0,0,95400,197702,84730,0,0,282432
21,Somalia,1,2014,SOM-14/DDA-3485/ER /FSC/UN/2312,4445,4627,3557,3571,16200,4445,4627,3557,3571,16200
21,Somalia,1,2014,SOM-14/DDA-3485/ER /EP/UN/2313,800,600,0,0,1400,616,462,0,0,1078
21,Somalia,2,2015,SOM-15/DDA-3485/SA  1/Shelter/INGO/2314,672,1008,1260,1260,4200,738,788,1617,1287,4430
21,Somalia,2,2015,SOM-15/DDA-3485/SA  1/Ed/INGO/2315,226,169,2387,2738,5520,231,128,2027,2738,5124
21,Somalia,2,2015,SOM-15/DDA-3485/SA  1/Ed/NGO/2318,55,47,1620,1620,3342,55,47,1872,1700,3674
21,Somalia,2,2015,SOM-15/DDA-3485/SA  1/H/UN/2320,15936,22825,10623,14216,63600,25969,33019,13732,14734,87454
21,Somalia,2,2015,SOM-15/DDA-3485/SA  1/FSC/INGO/2321,720,840,780,810,3150,720,840,780,810,3150
21,Somalia,2,2015,SOM-15/DDA-3485/SA  1/Nut/INGO/2323,10,10,484,546,1050,26,26,553,531,1136
21,Somalia,2,2015,SOM-15/DDA-3485/SA  1/EP/INGO/2324,40,40,0,0,80,0,0,0,0,0
21,Somalia,2,2015,SOM-15/DDA-3485/SA  1/WASH/INGO/2325,3430,3996,4190,4884,16500,4051,5091,6882,7837,23861
21,Somalia,2,2015,SOM-15/DDA-3485/SA  1/H/NGO/2335,1500,2500,800,800,5600,10608,12255,7175,7356,37394
21,Somalia,2,2015,SOM-15/DDA-3485/SA  1/FSC/INGO/2338,816,1344,1296,1344,4800,816,1344,1296,1344,4800
21,Somalia,2,2015,SOM-15/DDA-3485/SA  1/Nut/NGO/2340,26,1038,1200,1200,3464,26,1280,1540,1500,4346
21,Somalia,2,2015,SOM-15/DDA-3485/SA  1/FSC/INGO/2342,891,2079,1069,1361,5400,0,0,0,0,0
21,Somalia,2,2015,SOM-15/DDA-3485/SA  1/FSC/NGO/2346,3200,3200,800,800,8000,3200,3200,800,800,8000
21,Somalia,2,2015,SOM-15/DDA-3485/SA  1/Nut/INGO/2349,20,2512,1100,1100,4732,20,2891,912,1024,4847
21,Somalia,2,2015,SOM-15/DDA-3485/SA  1/H/UN/2353,60000,67000,15300,15300,157600,67500,71200,17600,18700,175000
21,Somalia,2,2015,SOM-15/DDA-3485/SA  1/FSC/UN/2355,2554,3826,638,956,7974,1390,4590,464,1530,7974
21,Somalia,2,2015,SOM-15/DDA-3485/SA  1/FSC/UN/2356,4675,4675,3825,3825,17000,4675,4675,3825,3825,17000
21,Somalia,2,2015,SOM-15/DDA-3485/SA  1/WASH/INGO/2357,5943,5754,4652,4652,21001,5943,5754,4652,4652,21001
21,Somalia,2,2015,SOM-15/DDA-3485/SA  1/FSC/UN/2358,1447,1447,2894,2894,8682,1539,2248,3728,3644,11159
21,Somalia,2,2015,SOM-15/DDA-3485/SA  1/WASH/INGO/2363,2515,2724,2724,2952,10915,2539,2761,2760,2980,11040
21,Somalia,2,2015,SOM-15/DDA-3485/SA  1/H/INGO/2364,21948,26054,9218,17456,74676,18012,36595,19361,18390,92358
21,Somalia,2,2015,SOM-15/DDA-3485/SA  1/H/NGO/2365,2100,5000,4300,5000,16400,1870,4653,4105,4232,14860
21,Somalia,2,2015,SOM-15/DDA-3485/SA  1/H/INGO/2369,662,13766,7213,7213,28854,980,4423,13880,13863,33146
21,Somalia,2,2015,SOM-15/DDA-3485/SA  1/H/NGO/2370,1440,4055,2000,2000,9495,1630,4390,2200,2250,10470
21,Somalia,2,2015,SOM-15/DDA-3485/SA  1/Nut/NGO/2371,150,600,900,900,2550,170,1030,1079,1104,3383
21,Somalia,2,2015,SOM-15/DDA-3485/SA  1/FSC/INGO/2372,591,927,694,1088,3300,326,966,1164,1047,3503
21,Somalia,2,2015,SOM-15/DDA-3485/SA  1/Shelter/NGO/2375,330,462,264,264,1320,334,462,270,264,1330
21,Somalia,2,2015,SOM-15/DDA-3485/SA  1/H/UN/2376,92,19332,40,40,19504,48,21078,826,1734,23686
21,Somalia,2,2015,SOM-15/DDA-3485/SA  1/H/INGO/2378,2100,13686,11044,12603,39433,1900,14219,12001,12972,41092
21,Somalia,2,2015,SOM-15/DDA-3485/SA  1/FSC/NGO/2380,300,750,450,450,1950,300,750,450,450,1950
21,Somalia,2,2015,SOM-15/DDA-3485/SA  1/WASH/UN/2382,2119,2825,4238,4899,14081,2126,2833,4249,4873,14081
21,Somalia,2,2015,SOM-15/DDA-3485/SA  1/H/INGO/2383,4205,6308,6307,9460,26280,3969,5995,5945,9180,25089
21,Somalia,2,2015,SOM-15/DDA-3485/SA  1/FSC/INGO/2384,485,1210,3390,3390,8475,2044,2101,4444,3227,11816
21,Somalia,2,2015,SOM-15/DDA-3485/SA  1/Nut/NGO/2385,15,1340,1596,1348,4299,15,1340,1596,1348,4299
21,Somalia,2,2015,SOM-15/DDA-3485/SA  1/Nut/INGO/2388,30,4572,5123,5123,14848,14441,16453,9480,10293,50667
21,Somalia,2,2015,SOM-15/DDA-3485/SA  1/Ed/INGO/2391,98,42,1657,1332,3129,51,14,1225,1036,2326
21,Somalia,2,2015,SOM-15/DDA-3485/SA  1/Nut/INGO/2392,68,1908,2668,4002,8646,49,7777,1834,2420,12080
21,Somalia,2,2015,SOM-15/DDA-3485/SA  1/Prot/UN/2402,925,3600,300,300,5125,1020,3416,200,230,4866
21,Somalia,2,2015,SOM-15/DDA-3485/SA  1/Prot/INGO/2404,10,210,0,0,220,65,355,25,46,491
21,Somalia,2,2015,SOM-15/DDA-3485/SA  1/EP/UN/2406,500000,500000,500000,500000,2000000,500000,500000,500000,500000,2000000
21,Somalia,2,2015,SOM-15/DDA-3485/SA  1/MsR/INGO/2407,635,1479,311,395,2820,501,887,651,620,2659
21,Somalia,2,2015,SOM-15/DDA-3485/SA  1/WASH/UN/2408,18750,18750,18750,18750,75000,18750,18750,18750,18750,75000
21,Somalia,2,2015,SOM-15/DDA-3485/SA  1/Shelter/NGO/2410,324,396,504,576,1800,324,396,504,576,1800
21,Somalia,2,2015,SOM-15/DDA-3485/SA  1/Prot/INGO/2412,335,515,335,405,1590,225,415,903,751,2294
21,Somalia,2,2015,SOM-15/DDA-3485/SA  1/WASH/NGO/2413,3668,5504,3385,5081,17638,0,0,0,0,0
21,Somalia,2,2015,SOM-15/DDA-3485/SA  1/EP/UN/2414,3751327,3751327,0,0,7502654,3751327,3751327,0,0,7502654
21,Somalia,2,2015,SOM-15/DDA-3485/SA  1/Prot/INGO/2415,2000,7000,1000,2500,12500,5813,11151,3505,5960,26429
21,Somalia,2,2015,SOM-15/DDA-3485/SA  1/Prot/INGO/2416,550,900,120,120,1690,663,1407,290,495,2855
21,Somalia,2,2015,SOM-15/DDA-3485/SA  1/Ed/INGO/2418,74,63,1335,1165,2637,85,52,1334,1152,2623
21,Somalia,2,2015,SOM-15/DDA-3485/SA  1/FSC/UN/2419,100170,66780,42930,28620,238500,184456,122972,79052,52702,439182
21,Somalia,2,2015,SOM-15/DDA-3485/SA  1/Prot/UN/2420,39130,63060,13309,37021,152520,298,2989,791,2573,6651
21,Somalia,2,2015,SOM-15/DDA-3485/SA  1/WASH/INGO/2422,2771,4567,4404,4568,16310,2802,4615,4450,4615,16482
21,Somalia,2,2015,SOM-15/DDA-3485/SA  1/WASH/NGO/2424,2100,3500,4200,4200,14000,2100,3500,4200,4200,14000
21,Somalia,2,2015,SOM-15/DDA-3485/SA  1/WASH/INGO/2428,3367,6493,2405,11783,24048,6565,6517,5627,5339,24048
21,Somalia,2,2015,SOM-15/DDA-3485/SA  1/WASH/INGO/2430,3314,4322,3168,3602,14406,3128,4508,2915,3855,14406
21,Somalia,2,2015,SOM-15/DDA-3485/SA  1/Shelter/INGO/2433,3924,4905,4905,5886,19620,1562,8746,6890,1400,18598
21,Somalia,2,2015,SOM-15/DDA-3485/SA  1/Ed/INGO/2436,695,643,1178,1209,3725,0,0,1427,1282,2709
21,Somalia,2,2015,SOM-15/DDA-3485/SA  1/Shelter/INGO/2442,1926,2166,3720,4200,12012,1639,2072,3902,3377,10990
21,Somalia,2,2015,SOM-15/DDA-3485/SA  1/WASH/UN/2443,2220,2960,4440,5180,14800,0,0,0,0,0
21,Somalia,2,2015,SOM-15/DDA-3485/SA  1/Shelter/INGO/2444,3449,5173,5974,2648,17244,5561,6015,1754,1779,15109
21,Somalia,2,2015,SOM-15/DDA-3485/SA  1/WASH/INGO/2445,2400,3150,3250,3900,12700,2400,3150,3250,3900,12700
21,Somalia,2,2015,SOM-15/DDA-3485/SA  1/WASH/UN/2447,40824,49896,32076,39204,162000,45977,56195,36125,44153,182450
21,Somalia,2,2015,SOM-15/DDA-3485/SA  1/WASH/INGO/2449,4805,7207,7207,10811,30030,5482,6225,12223,10337,34267
21,Somalia,2,2015,SOM-15/DDA-3485/SA  1/Ed/INGO/2451,57,40,1030,1030,2157,51,48,1041,1024,2164
21,Somalia,2,2015,SOM-15/DDA-3485/SA  1/Nut/UN/2453,0,0,7305,7018,14323,0,0,9478,9105,18583
21,Somalia,2,2015,SOM-15/DDA-3485/SA  1/H/INGO/2462,8,288,0,0,296,0,308,0,0,308
21,Somalia,2,2015,SOM-15/DDA-3485/SA  1/H/UN/2465,28000,32000,8000,12000,80000,24500,28000,7000,10500,70000
21,Somalia,2,2015,SOM-15/DDA-3485/SA  1/Nut/INGO/2466,0,1012,2410,2410,5832,0,4170,6399,5701,16270
21,Somalia,2,2015,SOM-15/DDA-3485/SA  1/Nut/INGO/2467,17,6079,331,332,6759,176,6071,414,484,7145
21,Somalia,2,2015,SOM-15/DDA-3485/SA  1/Nut/NGO/2468,17,3273,799,798,4887,17,3350,940,862,5169
21,Somalia,2,2015,SOM-15/DDA-3485/SA  1/Nut/INGO/2473,523,2072,1609,1609,5813,941,4637,1822,2815,10215
21,Somalia,1,2016,SOM-16/2470/R/WASH/INGO/2479,2652,2548,3978,3822,13000,2179,2329,6293,6952,17753
21,Somalia,1,2016,SOM-16/2470/R/WASH/INGO/2481,3528,3672,2352,2448,12000,5376,4704,3024,3696,16800
21,Somalia,1,2016,SOM-16/2470/R/WASH/UN/2482,1800,2400,3600,4200,12000,0,0,0,0,0
21,Somalia,1,2016,SOM-16/2470/R/Nut/INGO/2485,1183,17692,4073,4073,27021,458,24650,3750,4359,33217
21,Somalia,1,2016,SOM-16/2470/R/Nut/INGO/2486,345,1205,500,500,2550,313,1296,320,306,2235
21,Somalia,1,2016,SOM-16/2470/R/Nut/INGO/2487,0,500,1250,1250,3000,0,660,2966,3509,7135
21,Somalia,1,2016,SOM-16/2470/R/WASH/INGO/2488,3670,5504,5504,8255,22933,4876,7324,7300,10967,30467
21,Somalia,1,2016,SOM-16/2470/R/WASH/INGO/2489,8865,11914,9559,14287,44625,6999,8805,9185,11612,36601
21,Somalia,1,2016,SOM-16/2470/R/WASH/INGO/2491,2004,2505,2505,3006,10020,2043,2553,2555,3064,10215
21,Somalia,1,2016,SOM-16/2470/R/WASH/NGO/2494,2250,3750,4500,4500,15000,2250,3750,4500,4500,15000
21,Somalia,1,2016,SOM-16/2470/R/H/INGO/2500,3657,12164,13700,13701,43222,3425,10951,7523,8003,29902
21,Somalia,1,2016,SOM-16/2470/R/H/NGO/2501,9000,15000,18000,18000,60000,3465,14138,6972,10586,35161
21,Somalia,1,2016,SOM-16/2470/R/FSC/INGO/2502,1451,1394,1456,1399,5700,1452,1574,1545,1615,6186
21,Somalia,1,2016,SOM-16/2470/R/FSC/INGO/2503,1233,1513,1457,1401,5604,1420,1330,2409,2402,7561
21,Somalia,1,2016,SOM-16/2470/R/FSC/UN/2506,7643,5095,3275,2185,18198,120977,76946,50578,33745,282246
21,Somalia,1,2016,SOM-16/2470/R/FSC/INGO/2509,343,3337,0,0,3680,1250,1560,418,335,3563
21,Somalia,1,2016,SOM-16/2470/R/Prot/UN/2511,200,400,100,300,1000,195,410,90,315,1010
21,Somalia,1,2016,SOM-16/2470/R/Prot/INGO/2512,365,445,70,110,990,337,595,475,528,1935
21,Somalia,1,2016,SOM-16/2470/R/Prot/INGO/2514,812,812,1650,1650,4924,917,2141,1454,2201,6713
21,Somalia,1,2016,SOM-16/2470/R/Shelter/UN/2516,8000,10000,6000,6000,30000,8000,8000,7000,7000,30000
21,Somalia,1,2016,SOM-16/2470/R/EP/UN/2518,420,420,0,0,840,420,420,0,0,840
21,Somalia,1,2016,SOM-16/2470/R/EP/UN/2519,3,1,0,0,4,4,0,0,0,4
21,Somalia,1,2016,SOM-16/2470/R/WASH/NGO/2520,10120,12375,12380,15125,50000,10120,12375,12380,15125,50000
21,Somalia,1,2016,SOM-16/2470/R/Shelter/UN/2521,3840,5760,5760,8640,24000,8500,11500,2500,1500,24000
21,Somalia,1,2016,SOM-16/3485/R/Shelter/INGO/2526,578,556,248,238,1620,280,274,735,519,1808
21,Somalia,1,2016,SOM-16/2470/R/FSC/INGO/2527,714,1176,1134,1176,4200,714,1176,1134,1176,4200
21,Somalia,1,2016,SOM-16/3485/R/Shelter/NGO/2529,360,420,180,240,1200,360,420,180,240,1200
21,Somalia,1,2016,SOM-16/2470/R/Ed/INGO/2530,35,20,1100,900,2055,52,23,775,611,1461
21,Somalia,1,2016,SOM-16/3485/R/Prot/NGO/2532,700,1000,500,800,3000,700,1000,500,800,3000
21,Somalia,1,2016,SOM-16/3485/R/Shelter/INGO/2534,3842,5765,3842,5763,19212,5120,8192,3072,4096,20480
21,Somalia,1,2016,SOM-16/2470/R/H/INGO/2537,705,8315,2200,2977,14197,850,7926,2008,2580,13364
21,Somalia,1,2016,SOM-16/3485/R/FSC/INGO/2539,294,514,1505,1359,3672,294,514,1505,1359,3672
21,Somalia,1,2016,SOM-16/3485/R/H/NGO/2540,384,12307,3500,4174,20365,384,12307,3500,4174,20365
21,Somalia,1,2016,SOM-16/2470/R/H/INGO/2543,1976,3857,4617,2639,13089,2411,3943,3268,2593,12215
21,Somalia,1,2016,SOM-16/3485/R/Prot/INGO/2544,1090,2190,500,500,4280,2089,2813,1600,2358,8860
21,Somalia,1,2016,SOM-16/3485/R/Nut/NGO/2546,0,500,1000,1100,2600,0,600,1200,1190,2990
21,Somalia,1,2016,SOM-16/3485/R/Prot/INGO/2547,270,560,570,600,2000,350,1100,590,650,2690
21,Somalia,1,2016,SOM-16/2470/R/WASH/UN/2548,1875,2500,3750,4375,12500,1920,2560,3840,4480,12800
21,Somalia,1,2016,SOM-16/3485/R/FSC/INGO/2551,840,1260,840,1260,4200,840,1260,840,1260,4200
21,Somalia,1,2016,SOM-16/3485/R/Shelter/NGO/2552,812,869,638,681,3000,812,869,638,681,3000
21,Somalia,1,2016,SOM-16/2470/R/FSC/NGO/2553,550,680,550,440,2220,650,880,560,496,2586
21,Somalia,1,2016,SOM-16/3485/R/WASH/NGO/2554,4032,4368,3168,3432,15000,4032,4368,3168,3432,15000
21,Somalia,1,2016,SOM-16/3485/R/Nut/NGO/2556,10757,11190,2145,2233,26325,7203,17662,1532,1563,27960
21,Somalia,1,2016,SOM-16/3485/R/WASH/INGO/2557,5394,5183,2312,2221,15110,4785,5000,9568,9999,29352
21,Somalia,1,2016,SOM-16/3485/R/Nut/INGO/2558,1515,5013,1658,2158,10344,1721,8632,5153,5937,21443
21,Somalia,1,2016,SOM-16/2470/R/Nut/INGO/2560,56,291,0,0,347,0,673,0,0,673
21,Somalia,1,2016,SOM-16/2470/R/H/NGO/2561,1553,2071,3107,3624,10355,1778,2272,3760,3944,11754
21,Somalia,1,2016,SOM-16/3485/R/FSC/INGO/2567,633,875,1724,1793,5025,758,862,1897,1707,5224
21,Somalia,1,2016,SOM-16/3485/R/Nut/INGO/2569,1733,19926,4921,4921,31501,14609,22903,20349,25232,83093
21,Somalia,1,2016,SOM-16/3485/R/WASH/INGO/2570,5000,5483,5181,5484,21148,5985,6726,7190,6727,26628
21,Somalia,1,2016,SOM-16/2470/R/H/UN/2574,3950,5290,7920,9240,26400,12615,36589,16213,20538,85955
21,Somalia,1,2016,SOM-16/3485/R/Prot/INGO/2575,220,220,490,460,1390,850,1356,1076,921,4203
21,Somalia,1,2016,SOM-16/2470/R/Ed/INGO/2577,77,75,1116,1064,2332,86,56,676,586,1404
21,Somalia,1,2016,SOM-16/2470/R/Prot/UN/2578,45,1235,0,300,1580,47,1785,0,340,2172
21,Somalia,1,2016,SOM-16/3485/R/Prot/INGO/2579,6000,8000,120,610,14730,9403,16639,293,665,27000
21,Somalia,1,2016,SOM-16/2470/R/FSC/UN/2582,1950,3900,390,1560,7800,1950,3900,390,1560,7800
21,Somalia,1,2016,SOM-16/3485/R/Ed/INGO/3168,224,75,5500,4500,10299,221,79,5476,3994,9770
21,Somalia,1,2016,SOM-16/3485/R/EP/UN/3492,2359634,2320366,0,0,4680000,2359634,2320366,0,0,4680000
21,Somalia,1,2016,SOM-16/3485/R/Ed/NGO/3706,110,86,1800,1700,3696,103,93,1808,1892,3896
21,Somalia,1,2016,SOM-16/3485/R/WASH/INGO/3713,2779,3923,3355,3655,13712,3471,3914,4243,4784,16412
21,Somalia,1,2016,SOM-16/3485/R/Nut/NGO/3751,26,1038,1500,1500,4064,26,1179,1659,1715,4579
21,Somalia,1,2016,SOM-16/3485/R/H/NGO/3752,1440,4055,2000,2000,9495,1728,4460,2200,2300,10688
21,Somalia,1,2016,SOM-16/3485/R/Nut/INGO/3759,300,2700,1530,1470,6000,286,5476,1882,2666,10310
21,Somalia,1,2016,SOM-16/3485/R/H/INGO/3774,60,10320,9000,8000,27380,33,10747,6939,9019,26738
21,Somalia,1,2016,SOM-16/3485/R/Ed/INGO/3777,42,41,823,823,1729,42,41,900,746,1729
21,Somalia,1,2016,SOM-16/3485/R/WASH/NGO/3783,3142,3192,2537,2579,11450,3142,3192,2537,2579,11450
21,Somalia,1,2016,SOM-16/3485/R/WASH/NGO/3789,3103,4655,1034,1552,10344,3103,4655,1034,1552,10344
21,Somalia,1,2016,SOM-16/3485/R/Prot/NGO/3801,1515,1955,10,40,3520,504,2589,237,170,3500
21,Somalia,1,2016,SOM-16/3485/R/FSC/INGO/3817,143,254,737,666,1800,579,332,676,433,2020
21,Somalia,1,2016,SOM-16/3485/R/Prot/INGO/3824,1132,1132,1720,1720,5704,730,1080,2012,1788,5610
21,Somalia,1,2016,SOM-16/3485/R/Nut/INGO/3826,8,1774,1972,1950,5704,8,1755,1600,2127,5490
21,Somalia,1,2016,SOM-16/3485/R/H/NGO/3845,9800,11200,7000,7000,35000,9910,11940,6970,7824,36644
21,Somalia,1,2016,SOM-16/3485/R/Nut/NGO/3848,100,900,1350,1350,3700,100,2526,1290,1512,5428
21,Somalia,1,2016,SOM-16/3485/R/Shelter/INGO/3880,1080,1620,1350,1350,5400,1033,1269,1588,1546,5436
21,Somalia,1,2016,SOM-16/3485/R/H/UN/3885,4320,5760,8640,10080,28800,4103,6651,7185,8857,26796
21,Somalia,1,2016,SOM-16/3485/R/FSC/NGO/3891,261,391,87,131,870,261,391,87,131,870
21,Somalia,1,2016,SOM-16/3485/R/Nut/INGO/3893,1075,8850,3662,3663,17250,362,18765,5089,6543,30759
21,Somalia,1,2016,SOM-16/3485/R/FSC/INGO/3896,70,215,0,0,285,70,215,0,0,285
21,Somalia,1,2016,SOM-16/3485/R/Prot/NGO/3897,1920,6400,2000,2000,12320,1651,5955,1613,1840,11059
21,Somalia,1,2016,SOM-16/3485/R/Shelter/NGO/3898,1435,1349,1248,1368,5400,1435,1349,1248,1368,5400
21,Somalia,1,2016,SOM-16/3485/R/FSC/INGO/3901,28,150,0,0,178,28,155,422,413,1018
21,Somalia,1,2016,SOM-16/3485/R/FSC/UN/3902,706,1646,176,412,2940,706,1646,176,412,2940
21,Somalia,1,2016,SOM-16/3485/R/Shelter/UN/3903,810,1080,1620,1890,5400,747,1090,1673,1890,5400
21,Somalia,1,2016,SOM-16/3485/R/Prot/INGO/3905,600,736,701,850,2887,729,1457,1091,1036,4313
21,Somalia,1,2016,SOM-16/3485/R/H/INGO/3911,12084,21136,4028,4277,41525,8927,39121,13216,13228,74492
21,Somalia,1,2016,SOM-16/3485/R/Prot/UN/3916,520,1375,250,355,2500,1303,2714,300,597,4914
21,Somalia,1,2016,SOM-16/3485/R/Ed/INGO/3929,38,28,1140,1140,2346,40,26,1237,1098,2401
21,Somalia,1,2016,SOM-16/3485/R/Shelter/INGO/3930,1928,1852,826,794,5400,1298,1156,2002,1473,5929
21,Somalia,1,2016,SOM-16/3485/R/Prot/INGO/3948,3816,5016,75,381,9288,4624,5172,207,311,10314
21,Somalia,1,2016,SOM-16/3485/R/EP/INGO/4128,7500,2500,0,0,10000,7500,2500,0,0,10000
21,Somalia,1,2016,SOM-16/3485/R/WASH/INGO/4155,2261,2448,2261,2449,9419,2261,2448,2261,2449,9419
21,Somalia,1,2016,SOM-16/3485/R/EP/INGO/4328,40,40,0,0,80,42,42,0,0,84
21,Somalia,1,2015,SOM-15/3485/ER /WASH/INGO/4364,6336,6864,6336,6864,26400,22464,24336,0,0,46800
21,Somalia,1,2016,SOM-16/3485/R/Ed-WASH/INGO/4449,3240,3960,4290,3510,15000,2162,2450,6166,6086,16864
21,Somalia,1,2016,SOM-16/3485/R/WASH-Ed/INGO/4455,7282,7557,6694,6589,28122,7389,7344,9927,9345,34005
21,Somalia,1,2016,SOM-16/3485/R/WASH/INGO/4456,800,1470,1400,1330,5000,1652,1632,3027,2658,8969
21,Somalia,1,2016,SOM-16/3485/R/FSC/INGO/4458,530,874,842,874,3120,530,874,842,874,3120
21,Somalia,1,2016,SOM-16/3485/R/H/INGO/4460,9068,12210,2854,2854,26986,6028,13430,4179,5211,28848
21,Somalia,1,2016,SOM-16/3485/R/H/NGO/4463,7488,11232,2745,3495,24960,7488,11232,2745,3495,24960
21,Somalia,1,2016,SOM-16/3485/R/FSC/INGO/4468,2190,2122,1714,1714,7740,2184,1971,2683,2548,9386
21,Somalia,1,2016,SOM-16/3485/R/WASH-Ed/UN/4470,5468,6684,4297,5251,21700,6035,7376,4742,5796,23949
21,Somalia,1,2016,SOM-16/3485/R/H/NGO/4478,1650,2200,3300,3850,11000,971,1798,2240,3145,8154
21,Somalia,1,2016,SOM-16/3485/R/Nut/UN/4479,0,182250,4410,4590,191250,0,96428,4410,4590,105428
21,Somalia,1,2016,SOM-16/3485/R/FSC/INGO/4483,5775,5544,6006,5775,23100,9122,9655,4074,4236,27087
21,Somalia,1,2017,SOM-17/3485/R/H/INGO/4518,37291,36491,31766,29857,135405,29741,42675,16756,18275,107447
21,Somalia,2,2017,SOM-17/3485/SA1 2017/WASH/INGO/4529,4000,4400,3200,5800,17400,5362,5932,8336,7449,27079
21,Somalia,2,2017,SOM-17/3485/SA1 2017/H/NGO/4536,3500,4750,6600,7150,22000,3210,4715,6443,7874,22242
21,Somalia,2,2017,SOM-17/3485/SA1 2017/Nut/NGO/4538,140,2760,2600,2600,8100,18,2780,2650,2710,8158
21,Somalia,2,2017,SOM-17/3485/SA1 2017/Nut/INGO/4540,163,7064,9077,9077,25381,199,7557,9114,9286,26156
21,Somalia,2,2017,SOM-17/3485/SA1 2017/WASH/NGO/4541,4046,8092,14270,14270,40678,4078,8092,14270,14270,40710
21,Somalia,2,2017,SOM-17/3485/SA1 2017/H/NGO/4542,28785,19215,5800,6200,60000,29900,23694,6099,6971,66664
21,Somalia,2,2017,SOM-17/3485/SA1 2017/WASH/INGO/4543,2004,2199,2253,2544,9000,1787,2463,2718,2365,9333
21,Somalia,2,2017,SOM-17/3485/SA1 2017/Prot/NGO/4547,775,2075,55,95,3000,864,1549,2,62,2477
21,Somalia,2,2017,SOM-17/3485/SA1 2017/WASH/INGO/4548,1891,3115,3003,3115,11124,1891,3115,3003,3115,11124
21,Somalia,2,2017,SOM-17/3485/SA1 2017/H/INGO/4549,14273,32199,12075,12075,70622,12703,30861,11230,11713,66507
21,Somalia,2,2017,SOM-17/3485/SA1 2017/Nut/INGO/4550,16,3856,2100,2450,8422,16,3944,3020,3675,10655
21,Somalia,2,2017,SOM-17/3485/SA1 2017/Prot/INGO/4554,740,2315,1000,1180,5235,1280,3820,1200,1433,7733
21,Somalia,2,2017,SOM-17/3485/SA1 2017/WASH/INGO/4555,4050,7475,4814,8018,24357,6230,9500,6387,9250,31367
21,Somalia,2,2017,SOM-17/3485/SA1 2017/WASH/NGO/4560,8782,13173,2928,4391,29274,8782,13173,2928,4391,29274
21,Somalia,2,2017,SOM-17/3485/SA1 2017/Nut/NGO/4561,0,7869,484,727,9080,69,12043,3106,4659,19877
21,Somalia,2,2017,SOM-17/3485/SA1 2017/Ed/INGO/4563,149,148,1120,924,2341,149,148,1376,869,2542
21,Somalia,2,2017,SOM-17/3485/SA1 2017/FSC/INGO/4564,600,5300,50,50,6000,600,5300,50,50,6000
21,Somalia,2,2017,SOM-17/3485/SA1 2017/FSC/NGO/4568,712,875,4285,5238,11110,779,1092,4368,4681,10920
21,Somalia,2,2017,SOM-17/3485/SA1 2017/FSC/INGO/4569,714,1176,1134,1176,4200,714,1176,1134,1176,4200
21,Somalia,2,2017,SOM-17/3485/SA1 2017/FSC/NGO/4570,5686,8379,1862,2793,18720,5686,8379,1862,2793,18720
21,Somalia,2,2017,SOM-17/3485/SA1 2017/WASH/NGO/4571,2400,3600,2880,3120,12000,2440,3600,2900,3300,12240
21,Somalia,2,2017,SOM-17/3485/SA1 2017/Prot/NGO/4572,470,1597,493,493,3053,361,1778,57,178,2374
21,Somalia,2,2017,SOM-17/3485/SA1 2017/WASH/INGO/4574,9086,9844,18173,19687,56790,9086,9844,18173,19687,56790
21,Somalia,2,2017,SOM-17/3485/SA1 2017/FSC/NGO/4575,2169,4122,3308,4282,13881,2169,4122,3308,4282,13881
21,Somalia,2,2017,SOM-17/3485/SA1 2017/Ed/INGO/4577,52,34,1743,1314,3143,97,35,2030,1874,4036
21,Somalia,2,2017,SOM-17/3485/SA1 2017/Shelter/NGO/4580,2160,3240,2700,2700,10800,2160,3240,2700,2700,10800
21,Somalia,2,2017,SOM-17/3485/SA1 2017/H/INGO/4583,26411,97541,15481,15481,154914,20752,93546,16033,16624,146955
21,Somalia,2,2017,SOM-17/3485/SA1 2017/WASH/INGO/4586,7640,7398,5981,5981,27000,4432,12395,6051,6447,29325
21,Somalia,2,2017,SOM-17/3485/SA1 2017/FSC/INGO/4587,765,1797,647,1009,4218,1100,1623,684,811,4218
21,Somalia,2,2017,SOM-17/3485/SA1 2017/Nut/NGO/4588,20,1225,2000,2000,5245,20,1320,2140,2230,5710
21,Somalia,2,2017,SOM-17/3485/SA1 2017/Nut/NGO/4589,20,818,1500,1500,3838,20,868,1700,1800,4388
21,Somalia,2,2017,SOM-17/3485/SA1 2017/Ed/INGO/4591,77,48,1750,1750,3625,77,48,3208,2616,5949
21,Somalia,2,2017,SOM-17/3485/SA1 2017/WASH/NGO/4593,5276,5372,4553,4547,19748,5276,5372,4831,4759,20238
21,Somalia,2,2017,SOM-17/3485/SA1 2017/Prot/INGO/4594,555,4148,410,1565,6678,3606,2894,1500,2737,10737
21,Somalia,2,2017,SOM-17/3485/SA1 2017/H/NGO/4603,810,5010,6000,6000,17820,920,5200,6100,6150,18370
21,Somalia,2,2017,SOM-17/3485/SA1 2017/Nut/NGO/4604,18,1017,2000,2000,5035,18,1017,2100,2200,5335
21,Somalia,2,2017,SOM-17/3485/SA1 2017/Nut/NGO/4605,31,3402,3865,3640,10938,31,2855,3289,3375,9550
21,Somalia,2,2017,SOM-17/3485/SA1 2017/Prot/NGO/4606,412,818,75,75,1380,257,644,336,144,1381
21,Somalia,2,2017,SOM-17/3485/SA1 2017/Nut/INGO/4607,0,300,350,350,1000,0,276,440,588,1304
21,Somalia,2,2017,SOM-17/3485/SA1 2017/FSC/INGO/4608,850,1200,950,1200,4200,1323,1476,856,725,4380
21,Somalia,2,2017,SOM-17/3485/SA1 2017/Shelter/INGO/4609,3856,3704,1652,1588,10800,2453,2622,5191,4289,14555
21,Somalia,2,2017,SOM-17/3485/SA1 2017/Prot/INGO/4612,1496,2020,200,275,3991,859,2868,347,575,4649
21,Somalia,2,2017,SOM-17/3485/SA1 2017/Ed/INGO/4616,192,71,2400,1600,4263,215,52,4293,3332,7892
21,Somalia,2,2017,SOM-17/3485/SA1 2017/Nut/NGO/4618,18,2270,1445,1822,5555,23,2659,4123,4929,11734
21,Somalia,2,2017,SOM-17/3485/SA1 2017/Ed/INGO/4620,72,48,825,675,1620,56,29,965,875,1925
21,Somalia,2,2017,SOM-17/3485/SA1 2017/H/NGO/4622,8573,8958,7010,7985,32526,12723,14982,15061,15019,57785
21,Somalia,2,2017,SOM-17/3485/SA1 2017/FSC/INGO/4625,258,451,1321,1192,3222,258,451,1321,1192,3222
21,Somalia,2,2017,SOM-17/3485/SA1 2017/H/NGO/4628,4300,5200,2200,2300,14000,4300,5200,2200,2300,14000
21,Somalia,2,2017,SOM-17/3485/SA1 2017/FSC/NGO/4630,2592,3565,3888,4355,14400,2592,3565,3888,4355,14400
21,Somalia,2,2017,SOM-17/3485/SA1 2017/FSC/INGO/4633,4060,1540,0,0,5600,4060,1540,0,0,5600
21,Somalia,2,2017,SOM-17/3485/SA1 2017/FSC/NGO/4636,940,1280,0,0,2220,940,1280,0,0,2220
21,Somalia,2,2017,SOM-17/3485/SA1 2017/Ed/INGO/4638,226,93,1833,1733,3885,278,62,2088,1028,3456
21,Somalia,2,2017,SOM-17/3485/SA1 2017/Ed/INGO/4639,48,24,1036,755,1863,64,8,1045,798,1915
21,Somalia,2,2017,SOM-17/3485/SA1 2017/Prot/INGO/4642,2348,3523,293,470,6634,8046,13972,372,1065,23455
21,Somalia,2,2017,SOM-17/3485/SA1 2017/H/NGO/4645,3000,7500,9000,10500,30000,3000,7500,9000,10500,30000
21,Somalia,2,2017,SOM-17/3485/SA1 2017/WASH/NGO/4646,2250,3750,4500,4500,15000,2250,3750,4500,4500,15000
21,Somalia,2,2017,SOM-17/3485/SA1 2017/FSC/INGO/4652,1152,1728,1728,2592,7200,1316,1975,1974,2961,8226
21,Somalia,2,2017,SOM-17/3485/SA1 2017/WASH/NGO/4653,1889,3149,3781,3781,12600,1889,3149,3781,3781,12600
21,Somalia,2,2017,SOM-17/3485/SA1 2017/FSC/NGO/4659,4562,5179,3395,4012,17148,34260,38946,35616,43218,152040
21,Somalia,2,2017,SOM-17/3485/SA1 2017/WASH/NGO/4662,2310,3850,4620,4620,15400,2310,3850,4620,4620,15400
21,Somalia,2,2017,SOM-17/3485/SA1 2017/Nut/INGO/4663,21,5222,564,500,6307,21,9374,2214,2815,14424
21,Somalia,2,2017,SOM-17/3485/SA1 2017/Nut/INGO/4667,187,3146,750,750,4833,270,3196,785,812,5063
21,Somalia,2,2017,SOM-17/3485/SA1 2017/Ed/INGO/4672,55,45,587,424,1111,53,34,529,406,1022
21,Somalia,2,2017,SOM-17/3485/SA1 2017/Nut/INGO/4674,472,2465,1335,1282,5554,517,2930,1692,1755,6894
21,Somalia,2,2017,SOM-17/3485/SA1 2017/Nut/NGO/4676,0,1161,1980,1980,5121,0,1276,2178,2185,5639
21,Somalia,2,2017,SOM-17/3485/SA1 2017/WASH/INGO/4677,3710,4638,4637,5015,18000,3600,4501,4501,5401,18003
21,Somalia,2,2017,SOM-17/3485/SA1 2017/Prot/INGO/4678,4205,4604,5482,3789,18080,2684,2712,12363,9021,26780
21,Somalia,2,2017,SOM-17/3485/SA1 2017/Nut/NGO/4679,35,935,1200,1200,3370,70,1245,1175,1236,3726
21,Somalia,2,2017,SOM-17/3485/SA1 2017/WASH/INGO/4682,999,1221,3885,4995,11100,1149,1371,3885,4995,11400
21,Somalia,2,2017,SOM-17/3485/SA1 2017/Prot/INGO/4683,223,891,1040,1560,3714,260,1292,790,1376,3718
21,Somalia,2,2017,SOM-17/3485/SA1 2017/H/NGO/4687,3150,5250,6300,6300,21000,2835,5512,5985,6930,21262
21,Somalia,2,2017,SOM-17/3485/SA1 2017/Prot/INGO/4690,502,1375,565,1893,4335,1188,1440,1240,1981,5849
21,Somalia,2,2017,SOM-17/3485/SA1 2017/WASH/INGO/4691,3234,3366,2780,2620,12000,3936,4059,2337,1968,12300
21,Somalia,2,2017,SOM-17/3485/SA1 2017/Nut/INGO/4693,278,2003,2277,2369,6927,75,2514,2282,2398,7269
21,Somalia,2,2017,SOM-17/3485/SA1 2017/Prot/NGO/4699,207,1255,22,50,1534,83,1941,84,285,2393
21,Somalia,2,2017,SOM-17/3485/SA1 2017/WASH/INGO/4704,6619,11407,5638,9336,33000,20928,36067,17826,29519,104340
21,Somalia,2,2017,SOM-17/3485/SA1 2017/FSC/INGO/4706,648,2640,552,2160,6000,821,3344,699,2736,7600
21,Somalia,2,2017,SOM-17/3485/SA1 2017/Nut/INGO/4707,1082,12159,2629,2629,18499,757,21855,3894,4840,31346
21,Somalia,1,2017,SOM-17/3485/R/EP/UN/4734,3165758,3078242,0,0,6244000,3165758,3078242,0,0,6244000
21,Somalia,2,2017,SOM-17/3485/SA1 2017/H/INGO/4770,10930,18363,17136,19540,65969,6404,13518,10907,13211,44040
21,Somalia,1,2017,SOM-17/3485/R/EP/INGO/4978,2000000,2000000,200000,200000,4400000,2000000,2000000,200000,200000,4400000
21,Somalia,2,2017,SOM-17/3485/SA1 2017/H/NGO/4988,8600,19340,11510,11510,50960,8843,19427,12423,12058,52751
21,Somalia,2,2017,SOM-17/3485/SA1 2017/Prot/NGO/4997,10,10,450,810,1280,98,63,536,901,1598
21,Somalia,2,2017,SOM-17/3485/SA1 2017/H/O/5002,6443,14509,14941,16187,52080,867,16154,8875,8954,34850
21,Somalia,2,2017,SOM-17/3485/SA1 2017/Nut/NGO/5010,20,1020,1200,1200,3440,19,1096,939,953,3007
21,Somalia,2,2017,SOM-17/3485/SA1 2017/Ed/INGO/5037,50,43,1750,1750,3593,50,43,1985,1597,3675
21,Somalia,2,2017,SOM-17/3485/SA1 2017/Nut/NGO/5038,185,2815,1275,1275,5550,104,2875,1364,1432,5775
21,Somalia,2,2017,SOM-17/3485/SA1 2017/Ed/NGO/5039,65,7,1562,1042,2676,65,7,1473,1114,2659
21,Somalia,2,2017,SOM-17/3485/SA1 2017/FSC/INGO/5041,680,2772,580,2268,6300,828,3373,705,2759,7665
21,Somalia,2,2017,SOM-17/3485/SA1 2017/H/INGO/5048,41,26494,9614,9614,45763,81,44309,10300,11728,66418
21,Somalia,2,2017,SOM-17/3485/SA1 2017/Ed/NGO/5280,81,77,1485,1015,2658,102,56,1853,1547,3558
21,Somalia,2,2017,SOM-17/3485/SA1 2017/Prot/INGO/5298,119,163,535,535,1352,106,259,371,382,1118
21,Somalia,1,2017,SOM-17/3485/R/EP/INGO/5899,150,150,0,0,300,150,150,0,0,300
21,Somalia,1,2017,SOM-17/3485/R/Nut-H-WASH/INGO/6250,4821,9464,2789,3126,20200,4556,8560,2708,2932,18756
21,Somalia,1,2017,SOM-17/3485/R/Nut-H-WASH/NGO/6251,3109,5101,3500,4230,15940,3157,5159,3521,4361,16198
21,Somalia,1,2017,SOM-17/3485/R/Nut-H-WASH/NGO/6252,5875,9625,4500,4500,24500,5080,9723,4615,5263,24681
21,Somalia,1,2017,SOM-17/3485/R/Nut-H-WASH/NGO/6253,2760,6210,3243,3243,15456,2390,6138,3086,3423,15037
21,Somalia,1,2017,SOM-17/3485/R/Nut-H-WASH/NGO/6273,5550,8247,10451,10041,34289,4143,12587,12180,13254,42164
21,Somalia,1,2017,SOM-17/3485/R/FSC-Ed-WASH/INGO/6278,3720,3960,2040,2280,12000,3720,3960,2040,2280,12000
21,Somalia,1,2017,SOM-17/3485/R/FSC-Ed-WASH/INGO/6283,843,1596,1066,1072,4577,843,1345,1306,716,4210
21,Somalia,1,2017,SOM-17/3485/R/Shelter/INGO/6286,2100,6100,4000,5800,18000,2100,6100,4000,5800,18000
21,Somalia,1,2017,SOM-17/3485/R/Shelter-CCCM-WASH-Prot/INGO/6289,5454,6403,6811,7682,26350,6079,8543,7185,12526,34333
21,Somalia,1,2017,SOM-17/3485/R/Shelter/NGO/6290,4590,6120,2295,2295,15300,4590,6120,2295,2295,15300
21,Somalia,1,2017,SOM-17/3485/R/Prot/NGO/6291,70,70,2650,2650,5440,45,555,2475,2260,5335
21,Somalia,1,2017,SOM-17/3485/R/Prot/NGO/6292,620,1861,485,1044,4010,497,2179,344,1003,4023
21,Somalia,1,2017,SOM-17/3485/R/Shelter/NGO/6627,3420,4560,1710,1710,11400,3420,4560,1710,1710,11400
21,Somalia,1,2017,SOM-17/3485/R/Shelter/NGO/6629,810,1890,1080,1620,5400,810,1890,1080,1620,5400
21,Somalia,1,2017,SOM-17/3485/R/Prot/NGO/6631,536,1026,79,79,1720,215,1429,48,48,1740
21,Somalia,1,2017,SOM-17/3485/R/Prot/INGO/6634,520,840,1200,800,3360,3071,2648,3363,1919,11001
21,Somalia,1,2017,SOM-17/3485/R/Shelter/INGO/6638,1800,5500,3500,4200,15000,3791,3935,6304,5217,19247
21,Somalia,1,2017,SOM-17/3485/R/CCCM/INGO/6641,2835,2835,1215,1215,8100,5470,5470,2345,2345,15630
21,Somalia,1,2017,SOM-17/3485/R/Prot/NGO/6643,500,1134,950,1550,4134,292,1607,1786,1755,5440
21,Somalia,1,2017,SOM-17/3485/R/Ed-FSC-H-Nut-WASH/NGO/6662,14400,21150,4500,4950,45000,12766,22015,4823,5406,45010
21,Somalia,1,2017,SOM-17/3485/R/Ed-FSC-H-Nut-WASH/NGO/6663,5261,9499,2315,2050,19125,5525,10983,2345,2378,21231
21,Somalia,1,2017,SOM-17/3485/R/FSC-H-Nut-WASH/O/6664,14252,32094,33050,35805,115201,3925,21553,10993,12709,49180
21,Somalia,1,2017,SOM-17/3485/R/Ed-FSC-H-Nut-WASH/INGO/6668,9069,16288,7576,6922,39855,9069,16288,7576,6922,39855
21,Somalia,1,2017,SOM-17/3485/R/Ed-FSC-H-Nut-WASH/INGO/6669,2425,4136,3709,3994,14264,937,1731,6957,7018,16643
21,Somalia,1,2017,SOM-17/3485/R/Ed-FSC-H-Nut-WASH/NGO/6672,4915,5325,1280,1280,12800,4935,5508,1709,1862,14014
21,Somalia,1,2017,SOM-17/3485/R/Ed-FSC-H-Nut-WASH/INGO/6676,7887,7993,3969,3591,23440,13132,19308,9906,9915,52261
21,Somalia,1,2017,SOM-17/3485/R/Ed-FSC-H-Nut-WASH/INGO/6677,16,26017,8179,8179,42391,6,14629,5060,5610,25305
21,Somalia,1,2017,SOM-17/3485/R/WASH-FSC/INGO/6688,6666,6486,5500,5348,24000,19704,27736,15984,21834,85258
21,Somalia,1,2017,SOM-17/3485/R/WASH/NGO/6747,3511,4255,5600,6750,20116,3436,4450,4948,6539,19373
21,Somalia,1,2017,SOM-17/3485/R/FSC-WASH-Ed-H-Nut/NGO/6751,4240,4858,6194,7372,22664,261,796,388,456,1901
21,Somalia,1,2017,SOM-17/3485/R/Prot-Shelter/NGO/6758,3807,5702,8478,8334,26321,963,4214,2633,1771,9581
21,Somalia,1,2017,SOM-17/3485/R/Ed-FSC-H-Nut-WASH/NGO/6776,5134,7701,374,468,13677,3388,5082,374,468,9312
21,Somalia,1,2017,SOM-17/3485/R/FSC-Ed-H-Nut-WASH/INGO/6813,6200,8900,2303,2597,20000,3300,6241,2450,2538,14529
21,Somalia,1,2017,SOM-17/3485/R/H/UN/6830,0,0,222757,222757,445514,0,0,224217,224216,448433
21,Somalia,1,2017,SOM-17/3485/R/EP/INGO/6901,7500,2500,0,0,10000,7500,2500,0,0,10000
21,Somalia,1,2017,SOM-17/3485/R/EP/INGO/6902,40,40,0,0,80,37,36,0,0,73
21,Somalia,1,2017,SOM-17/3485/R/Ed-FSC-H-Nut-WASH/NGO/6918,8842,14735,6900,6900,37377,8414,9423,6169,5994,30000
21,Somalia,2,2017,SOM-17/3485/SA2/Ed-FSC-H-Nut-WASH/NGO/7402,4500,5500,7500,7500,25000,4349,5782,7438,7820,25389
21,Somalia,2,2017,SOM-17/3485/SA2/WASH/INGO/7407,3664,4194,3570,2856,14284,0,0,0,0,0
21,Somalia,2,2017,SOM-17/3485/SA2/H-Nut-WASH/NGO/7410,4496,9112,6446,6446,26500,7206,16348,7790,8027,39371
21,Somalia,2,2017,SOM-17/3485/SA2/H-WASH-Nut/NGO/7413,2000,3200,2800,3000,11000,1200,2200,1500,1700,6600
21,Somalia,2,2017,SOM-17/3485/SA2/FSC/NGO/7414,600,800,1100,1400,3900,600,800,1100,1400,3900
21,Somalia,2,2017,SOM-17/3485/SA2/FSC/INGO/7419,1000,1200,1300,1318,4818,241,337,102,123,803
21,Somalia,2,2017,SOM-17/3485/SA2/CCCM-Shelter-Prot/INGO/7425,4200,5920,5879,6033,22032,1651,5894,2263,3052,12860
21,Somalia,2,2017,SOM-17/3485/SA2/H/INGO/7435,3480,5845,5445,6221,20991,1058,3351,1397,1544,7350
21,Somalia,2,2017,SOM-17/3485/SA2/H-Nut-WASH-Ed-FSC/INGO/7464,10,23058,7200,7200,37468,15,4626,1255,1506,7402
21,Somalia,2,2017,SOM-17/3485/SA2/Prot/INGO/7472,1268,1314,1930,1950,6462,571,1597,628,1160,3956
21,Somalia,2,2017,SOM-17/3485/SA2/WASH-Nut-H/NGO/7476,3446,4535,4353,5804,18138,2721,5326,3610,4202,15859
21,Somalia,2,2017,SOM-17/3485/SA2/FSC-H-WASH-Nut-Ed/NGO/7477,6125,7575,5100,6200,25000,3863,4387,2950,3900,15100
21,Somalia,2,2017,SOM-17/3485/SA2/H/NGO/7484,23670,18103,9582,13645,65000,8627,11746,5632,9445,35450
21,Somalia,2,2017,SOM-17/3485/SA2/Nut/NGO/7497,12,1513,3500,3700,8725,12,520,1420,1720,3672
21,Somalia,2,2017,SOM-17/3485/SA2/WASH/INGO/7512,1234,7460,1106,2200,12000,1234,7460,1106,2200,12000
21,Somalia,2,2017,SOM-17/3485/SA2/Ed-FSC-H-Nut-WASH/INGO/7531,2706,6192,3289,4801,16988,637,2000,1162,969,4768
21,Somalia,2,2017,SOM-17/3485/SA2/Prot-Shelter-CCCM/NGO/7549,1377,1968,1557,2278,7180,1076,2489,1861,1790,7216
21,Somalia,2,2017,SOM-17/3485/SA2/FSC-WASH-H-Nut-Ed/INGO/7551,2620,3180,2100,2100,10000,1270,1053,1323,1259,4905
21,Somalia,2,2017,SOM-17/3485/SA2/Shelter-CCCM-Prot/NGO/7553,4500,6000,2250,2250,15000,4500,6000,2250,2250,15000
21,Somalia,2,2017,SOM-17/3485/SA2/FSC/NGO/7554,800,1000,0,0,1800,800,1000,0,0,1800
21,Somalia,2,2017,SOM-17/3485/SA2/Ed-H-Nut-FSC-WASH/NGO/7572,6480,7020,6480,7020,27000,1138,1605,1499,1630,5872
21,Somalia,2,2017,SOM-17/3485/SA2/Shelter-CCCM-FSC/NGO/7575,2880,4320,1920,2880,12000,583,6658,389,4450,12080
21,Somalia,2,2017,SOM-17/3485/SA2/Ed/INGO/7581,275,128,3111,2055,5569,251,119,4079,3079,7528
21,Somalia,2,2017,SOM-17/3485/SA2/FSC/INGO/7583,1708,1726,2414,2314,8162,1721,1814,2458,2516,8509
21,Somalia,2,2017,SOM-17/3485/SA2/Shelter/INGO/7587,1440,1440,3360,3360,9600,1801,1985,3736,3012,10534
21,Somalia,2,2017,SOM-17/3485/SA2/Nut/INGO/7588,2290,9517,1065,1065,13937,440,9837,65,79,10421
21,Somalia,2,2017,SOM-17/3485/SA2/Shelter-Prot-CCCM/NGO/7590,825,1320,801,954,3900,825,1320,801,954,3900
21,Somalia,2,2017,SOM-17/3485/SA2/H-Nut-WASH/INGO/7596,9439,9788,7691,8040,34958,1051,4426,2471,2896,10844
21,Somalia,2,2017,SOM-17/3485/SA2/L/UN/7647,2000,2000,0,0,4000,2025,2025,0,0,4050
21,Somalia,2,2018,SOM-18/3485/SA1/Nut-WASH-H/NGO/8455,1410,3901,3000,3200,11511,640,1893,1694,1732,5959
21,Somalia,2,2018,SOM-18/3485/SA1/FSC/INGO/8465,1096,1806,1742,1806,6450,3576,3402,5500,5318,17796
21,Somalia,2,2018,SOM-18/3485/SA1/H/NGO/8470,9488,13232,4745,5895,33360,5023,6415,2890,3015,17343
21,Somalia,2,2018,SOM-18/3485/SA1/Nut/NGO/8472,29,7155,8065,7749,22998,29,3748,4240,3923,11940
21,Somalia,2,2018,SOM-18/3485/SA1/Prot/NGO/8477,520,1240,1000,1400,4160,200,500,600,900,2200
21,Somalia,2,2018,SOM-18/3485/SA1/H-Nut-WASH/NGO/8493,14600,23800,12800,12800,64000,7136,16854,8987,11909,44886
21,Somalia,2,2018,SOM-18/3485/SA1/CCCM-Prot-WASH-Shelter/INGO/8505,10829,11731,12211,13229,48000,3400,4380,4284,4359,16423
21,Somalia,2,2018,SOM-18/3485/SA1/Shelter/INGO/8506,900,900,2100,2100,6000,1142,1304,2847,2394,7687
21,Somalia,2,2018,SOM-18/3485/SA1/FSC/INGO/8529,1758,1581,2339,2272,7950,2040,1651,3540,3126,10357
21,Somalia,2,2018,SOM-18/3485/SA1/Prot/NGO/8533,295,310,1075,735,2415,141,303,1012,947,2403
21,Somalia,2,2018,SOM-18/3485/SA1/H-Nut-WASH/NGO/8538,8400,17900,11600,11600,49500,2579,8366,3184,3837,17966
21,Somalia,2,2018,SOM-18/3485/SA1/Ed/INGO/8577,90,8,1450,855,2403,90,8,1450,855,2403
21,Somalia,2,2018,SOM-18/3485/SA1/FSC/NGO/8596,1259,1389,576,658,3882,525,727,1417,1534,4203
21,Somalia,2,2018,SOM-18/3485/SA1/Prot/INGO/8609,251,437,731,983,2402,201,362,603,846,2012
21,Somalia,2,2018,SOM-18/3485/SA1/FSC/INGO/8612,2412,2773,4305,4182,13672,1633,1748,3152,2858,9391
21,Somalia,2,2018,SOM-18/3485/SA1/FSC/INGO/8618,150,300,100,126,676,290,386,0,0,676
21,Somalia,2,2018,SOM-18/3485/SA1/Ed/INGO/8625,140,60,2400,1600,4200,158,53,2803,1800,4814
21,Somalia,2,2018,SOM-18/3485/SA1/CCCM/INGO/8629,12811,13018,10482,10650,46961,7258,8578,7679,7231,30746
21,Somalia,2,2018,SOM-18/3485/SA1/Ed/NGO/8641,71,41,1800,1200,3112,68,44,1480,1217,2809
21,Somalia,2,2018,SOM-18/3485/SA1/Prot/NGO/8651,523,1173,135,175,2006,30,151,30,36,247
21,Somalia,2,2018,SOM-18/3485/SA1/Shelter/NGO/8653,1100,1200,1300,1600,5200,770,840,910,1120,3640
21,Somalia,2,2018,SOM-18/3485/SA1/H/INGO/8654,24161,30751,26357,28554,109823,15206,25683,10108,12539,63536
21,Somalia,2,2018,SOM-18/3485/SA1/Prot-WASH-Shelter-CCCM/NGO/8658,2445,4504,1799,3264,12012,546,1986,351,1165,4048
21,Somalia,2,2018,SOM-18/3485/SA1/CCCM-WASH-Shelter/INGO/8671,5400,7020,7560,7020,27000,105,107,0,0,212
21,Somalia,2,2018,SOM-18/3485/SA1/Prot/NGO/8672,270,560,570,600,2000,445,855,0,0,1300
21,Somalia,2,2018,SOM-18/3485/SA1/CCCM/INGO/8673,7445,8065,8395,9095,33000,10,10,0,0,20
21,Somalia,2,2018,SOM-18/3485/SA1/WASH/NGO/8675,2817,3485,2346,2852,11500,1960,2424,1632,1984,8000
21,Somalia,2,2018,SOM-18/3485/SA1/Prot/NGO/8676,1030,1597,884,929,4440,109,1074,187,218,1588
21,Somalia,2,2018,SOM-18/3485/SA1/Shelter/NGO/8681,7200,9600,3600,3600,24000,2760,2070,1035,1035,6900
21,Somalia,2,2018,SOM-18/3485/SA1/Shelter-WASH-CCCM-Prot/NGO/8682,5400,7200,2700,2700,18000,1350,1800,675,675,4500
21,Somalia,2,2018,SOM-18/3485/SA1/WASH/INGO/8692,23366,24564,5991,5991,59912,13595,17090,15845,16417,62947
21,Somalia,2,2018,SOM-18/3485/SA1/FSC/NGO/8694,1962,2264,1510,1812,7548,1786,2061,1375,1649,6871
21,Somalia,2,2018,SOM-18/3485/SA1/Ed/NGO/8703,37,22,600,500,1159,42,17,600,500,1159
21,Somalia,2,2018,SOM-18/3485/SA1/WASH/NGO/8711,6174,7636,5140,6250,25200,4900,6060,4080,4960,20000
21,Somalia,2,2018,SOM-18/3485/SA1/H/NGO/8748,35,20218,5920,6691,32864,28,8482,2430,2834,13774
21,Somalia,2,2018,SOM-18/3485/SA1/WASH-Nut-H/NGO/8750,1000,2000,1500,1500,6000,538,1205,674,739,3156
21,Somalia,2,2018,SOM-18/3485/SA1/FSC-WASH-Nut-H-Ed/NGO/8758,6410,9384,3675,3675,23144,942,3712,3202,4047,11903
21,Somalia,2,2018,SOM-18/3485/SA1/WASH/INGO/8766,3720,3960,2040,2280,12000,3720,3960,2040,2280,12000
21,Somalia,2,2018,SOM-18/3485/SA1/L/UN/8898,850,850,0,0,1700,1051,1052,0,0,2103
21,Somalia,1,2018,SOM-18/3485/RA1/Prot/NGO/9214,424,676,3584,3256,7940,236,248,3761,3064,7309
21,Somalia,1,2018,SOM-18/3485/RA1/Ed-Prot/NGO/9216,1525,2327,4884,4980,13716,1081,817,1634,1243,4775
21,Somalia,1,2018,SOM-18/3485/RA1/Ed-Prot/NGO/9221,1083,1285,1800,1400,5568,795,1132,1073,906,3906
21,Somalia,1,2018,SOM-18/3485/RA1/Ed-Prot/INGO/9224,70,50,3200,2029,5349,70,50,899,663,1682
21,Somalia,1,2018,SOM-18/3485/RA1/H-Ed-Nut-WASH/INGO/9502,27750,30393,35679,38322,132144,11100,12157,14272,15329,52858
21,Somalia,1,2018,SOM-18/3485/RA2018/H-Nut-WASH/O/9577,9211,16821,6869,7149,40050,300,600,623,510,2033
21,Somalia,1,2018,SOM-18/3485/RA2018/FSC/NGO/9579,933,1276,1227,1472,4908,683,1293,868,1518,4362
21,Somalia,1,2018,SOM-18/3485/RA2018/FSC/NGO/9580,2231,2636,2535,2738,10140,2231,2636,2535,2738,10140
21,Somalia,1,2018,SOM-18/3485/RA2018/Shelter-Prot/NGO/9590,1827,3350,3273,3606,12056,210,578,110,170,1068
19,South Sudan,2,2015,SSD-15/SA1/FSL/UN/147,38375,42983,0,0,81358,144072,132989,149613,121907,548581
19,South Sudan,2,2015,SSD-15/SA1/P/INGO/157,13000,44500,21500,25000,104000,77689,90071,54019,56518,278297
19,South Sudan,2,2015,SSD-15/SA1/CCCM/INGO/161,177000,178000,2000,2000,359000,177000,178000,2000,2000,359000
19,South Sudan,2,2015,SSD-15/SA1/H/INGO/166,5174,7661,2786,4279,19900,4919,8238,6612,6838,26607
19,South Sudan,2,2015,SSD-15/SA1/H/NGO/167,21480,81800,8670,8050,120000,16106,41818,5754,5911,69589
19,South Sudan,2,2015,SSD-15/SA1/WASH/NGO/188,2300,6200,3500,4575,16575,2563,6153,3393,7683,19792
19,South Sudan,2,2015,SSD-15/SA1/P/NGO/191,3000,4500,3750,3750,15000,3359,5338,4715,4750,18162
19,South Sudan,2,2015,SSD-15/SA1/CCCM/NGO/192,1000,2000,1500,2500,7000,1740,5320,3360,2880,13300
19,South Sudan,2,2015,SSD-15/SA1/H/UN/195,0,59639,549402,571826,1180867,0,98820,484446,504219,1087485
19,South Sudan,2,2015,SSD-15/SA1/WASH/NGO/199,4000,11000,5000,7000,27000,3160,8690,3950,5530,21330
19,South Sudan,2,2015,SSD-15/SA1/WASH/INGO/204,8050,8400,9100,9450,35000,8573,8946,9692,10065,37276
19,South Sudan,2,2015,SSD-15/SA1/FSL/NGO/210,10000,15000,4000,6000,35000,16784,8985,0,0,25769
19,South Sudan,2,2015,SSD-15/SA1/N/UN/214,0,0,8204,10260,18464,0,0,8200,10264,18464
19,South Sudan,2,2015,SSD-15/SA1/H/INGO/216,24434,34208,19547,19547,97736,20560,27529,10627,11952,70668
19,South Sudan,2,2015,SSD-15/SA1/E/NGO/220,1000,1000,1000,1000,4000,1776,643,536,379,3334
19,South Sudan,2,2015,SSD-15/SA1/NFI/INGO/222,10454,14636,4785,11943,41818,6299,8168,9874,11167,35508
19,South Sudan,2,2015,SSD-15/SA1/H/NGO/223,22400,29000,12460,12460,76320,19300,18960,9950,10080,58290
19,South Sudan,2,2015,SSD-15/SA1/WASH/NGO/226,13236,15884,9530,14295,52945,13236,15884,9530,14295,52945
19,South Sudan,2,2015,SSD-15/SA1/FSL/INGO/233,30443,35704,44144,26040,136331,20213,16824,25829,23205,86071
19,South Sudan,2,2015,SSD-15/SA1/H/NGO/234,20864,27126,29400,29580,106970,12550,12550,8750,8750,42600
19,South Sudan,2,2015,SSD-15/SA1/P/NGO/235,1045,5045,1000,2000,9090,2030,11600,2500,4800,20930
19,South Sudan,2,2015,SSD-15/SA1/FSL/INGO/242,7854,7306,13986,12854,42000,6705,10125,10233,10119,37182
19,South Sudan,2,2015,SSD-15/SA1/E/INGO/243,110,54,1360,2040,3564,94,40,2177,2034,4345
19,South Sudan,2,2015,SSD-15/SA1/FSL/UN/244,10884,24987,25569,32560,94000,6237,17469,22707,24523,70936
19,South Sudan,2,2015,SSD-15/SA1/H/NGO/245,8792,16956,19468,17584,62800,10084,16846,7023,7323,41276
19,South Sudan,2,2015,SSD-15/SA1/N/NGO/250,1928,4500,4746,4746,15920,2246,5822,8494,6719,23281
19,South Sudan,2,2015,SSD-15/SA1/ETC/UN/251,1,0,0,0,1,0,0,0,0,0
19,South Sudan,2,2015,SSD-15/SA1/H/UN/255,31457,30223,27896,26803,116379,69436,65442,61556,70896,267330
19,South Sudan,2,2015,SSD-15/SA1/N/UN/256,0,0,10669,11105,21774,0,0,8820,9180,18000
19,South Sudan,2,2015,SSD-15/SA1/P/NGO/262,255,566,3730,3640,8191,1090,2798,22732,20262,46882
19,South Sudan,2,2015,SSD-15/SA1/E/INGO/265,135,75,2100,1400,3710,373,399,1601,997,3370
19,South Sudan,2,2015,SSD-15/SA1/E/NGO/267,188,158,4749,3980,9075,161,133,3942,2776,7012
19,South Sudan,2,2015,SSD-15/SA1/E/NGO/268,200,75,1500,1500,3275,280,100,2208,1446,4034
19,South Sudan,2,2015,SSD-15/SA1/P/NGO/272,921,1200,3355,4595,10071,1722,3383,3959,4646,13710
19,South Sudan,2,2015,SSD-15/SA1/FSL/INGO/275,13830,14854,11720,10818,51222,13379,14007,12049,12040,51475
19,South Sudan,2,2015,SSD-15/SA1/CCCM/INGO/281,600,2417,1000,1000,5017,600,2417,1000,1000,5017
19,South Sudan,2,2015,SSD-15/SA1/E/INGO/282,78,122,2212,1378,3790,78,122,2212,1378,3790
19,South Sudan,2,2015,SSD-15/SA1/E/UN/287,480,260,32730,21830,55300,516,286,42725,22903,66430
19,South Sudan,2,2015,SSD-15/SA1/P/UN/288,500,1000,500,750,2750,641,1589,248,551,3029
19,South Sudan,2,2015,SSD-15/SA1/L/UN/291,23,0,0,0,23,23,0,0,0,23
19,South Sudan,2,2015,SSD-15/SA1/P/NGO/292,1200,21600,3336,3336,29472,1499,21540,1726,3037,27802
19,South Sudan,2,2015,SSD-15/SA1/E/UN/293,140,60,4680,3120,8000,108,29,3260,1666,5063
19,South Sudan,2,2015,SSD-15/SA1/NFI/INGO/294,6000,14000,10000,10000,40000,6722,12058,6722,12059,37561
19,South Sudan,2,2015,SSD-15/SA1/WASH/NGO/298,2000,4000,5320,4680,16000,3090,5900,6689,6821,22500
19,South Sudan,2,2015,SSD-15/SA1/NFI/NGO/300,1200,2300,2000,2000,7500,2100,3300,2500,2700,10600
19,South Sudan,2,2015,SSD-15/SA1/N/UN/303,0,21334,0,0,21334,0,26165,0,0,26165
19,South Sudan,2,2015,SSD-15/SA1/WASH/UN/305,12822,14495,13938,14495,55750,19200,21700,20900,21700,83500
19,South Sudan,2,2015,SSD-15/SA1/E/INGO/307,1925,1056,699,376,4056,1620,1077,963,653,4313
19,South Sudan,2,2015,SSD-15/SA1/NFI/INGO/308,15190,19784,3798,4946,43718,19702,25331,5067,6192,56292
19,South Sudan,2,2015,SSD-15/SA1/FSL/INGO/310,780,620,0,0,1400,754,646,0,0,1400
19,South Sudan,2,2015,SSD-15/SA1/H/INGO/314,3332,3204,3332,2947,12815,19925,19143,8521,8186,55775
19,South Sudan,2,2015,SSD-15/SA1/P/INGO/316,1034,2101,1870,1580,6585,1332,7320,5437,8557,22646
19,South Sudan,2,2015,SSD-15/SA1/L/UN/320,0,0,0,0,0,0,0,0,0,0
19,South Sudan,2,2015,SSD-15/SA1/NFI/INGO/321,5400,8100,6750,6750,27000,20009,25878,802,2127,48816
19,South Sudan,2,2015,SSD-15/SA1/H/INGO/322,157470,60651,10639,10228,238988,161220,57162,12418,13115,243915
19,South Sudan,2,2015,SSD-15/SA1/WASH/UN/323,35560,40200,38640,40200,154600,34500,40500,37500,39000,151500
19,South Sudan,2,2015,SSD-15/SA1/P/INGO/324,1200,1200,1800,1800,6000,715,1704,2032,1740,6191
19,South Sudan,2,2015,SSD-15/SA1/NFI/UN/326,28080,46805,77220,81895,234000,30334,50560,83420,88476,252790
19,South Sudan,2,2015,SSD-15/SA1/WASH/INGO/331,3570,5250,6510,5670,21000,772,2145,2917,2476,8310
19,South Sudan,2,2015,SSD-15/SA1/WASH/UN/332,12531,16708,14919,15516,59674,36857,49142,43879,45636,175514
19,South Sudan,2,2015,SSD-15/SA1/NFI/UN/336,3622,8453,11270,16905,40250,3622,8453,11270,16905,40250
19,South Sudan,2,2015,SSD-15/SA1/N/INGO/338,50,1110,3340,3618,8118,10,405,1058,1218,2691
19,South Sudan,2,2015,SSD-15/SA1/E/NGO/339,40,40,2175,2102,4357,50,30,2918,1359,4357
19,South Sudan,2,2015,SSD-15/SA1/H/NGO/341,19640,22615,9087,9087,60429,16850,23600,7800,10200,58450
19,South Sudan,2,2015,SSD-15/SA1/N/NGO/342,1234,5530,7713,8008,22485,2556,3240,12852,12439,31087
19,South Sudan,2,2015,SSD-15/SA1/N/INGO/345,525,21085,28250,28250,78110,1323,13070,6686,6330,27409
19,South Sudan,2,2015,SSD-15/SA1/H/NGO/346,16920,32900,22310,21870,94000,18330,29782,26990,25052,100154
19,South Sudan,2,2015,SSD-15/SA1/H/UN/356,29355,28203,26031,25011,108600,26700,27584,24536,23567,102387
19,South Sudan,2,2015,SSD-15/SA1/CCCM/INGO/359,18564,31239,36952,40045,126800,33955,49877,7184,7162,98178
19,South Sudan,2,2015,SSD-15/SA1/N/INGO/362,30,1456,3300,3300,8086,765,2552,2028,1456,6801
19,South Sudan,2,2015,SSD-15/SA1/N/INGO/365,220,880,15999,16652,33751,2132,8271,5656,5557,21616
19,South Sudan,2,2015,SSD-15/SA1/N/INGO/368,7440,29260,34470,32198,103368,5542,63131,31579,34210,134462
19,South Sudan,2,2015,SSD-15/SA1/H/INGO/369,10551,15825,13187,13187,52750,43878,54274,15103,15082,128337
19,South Sudan,2,2015,SSD-15/SA1/WASH/INGO/373,21192,22958,26808,29042,100000,29725,41338,18232,22527,111822
19,South Sudan,2,2015,SSD-15/SA1/N/UN/374,0,75000,95625,91875,262500,0,77910,88362,85464,251736
19,South Sudan,2,2015,SSD-15/SA1/WASH/INGO/375,24800,26400,13600,15200,80000,30080,33653,48234,45088,157055
19,South Sudan,2,2015,SSD-15/SA1/P/UN/377,0,0,13225,13225,26450,0,0,13225,13225,26450
19,South Sudan,2,2015,SSD-15/SA1/N/INGO/379,3195,2667,6117,6897,18876,155,6351,7664,7784,21954
19,South Sudan,2,2015,SSD-15/SA1/P/INGO/385,1590,2002,2730,3416,9738,2243,2331,2575,1516,8665
19,South Sudan,2,2015,SSD-15/SA1/H/UN/387,34251,35648,8389,9086,87374,45753,158659,120286,44277,368975
19,South Sudan,2,2015,SSD-15/SA1/P/UN/389,0,31160,0,50840,82000,475,29688,2494,26719,59376
19,South Sudan,2,2015,SSD-15/SA1/H/INGO/390,7500,11800,5200,3800,28300,5380,7184,4983,3776,21323
19,South Sudan,2,2015,SSD-15/SA1/H/INGO/391,12542,13054,3401,3539,32536,3146,4343,1584,1649,10722
19,South Sudan,2,2015,SSD-15/SA1/N/INGO/392,560,39504,14570,11842,66476,865,27903,18506,18534,65808
19,South Sudan,2,2015,SSD-15/SA1/CCCM/UN/394,150180,202638,202338,194844,750000,157062,211967,211722,203880,784631
19,South Sudan,2,2015,SSD-15/SA1/FSL/INGO/396,7804,3662,1872,1452,14790,7171,2070,1006,567,10814
19,South Sudan,2,2015,SSD-15/SA1/WASH/UN/398,1879,5697,6329,6673,20578,2275,6568,7304,7721,23868
19,South Sudan,2,2015,SSD-15/SA1/P/INGO/400,680,640,50,50,1420,584,794,148,132,1658
19,South Sudan,2,2015,SSD-15/SA1/CCCM/INGO/402,3303,4912,4567,4696,17478,9000,12735,11250,11970,44955
19,South Sudan,2,2015,SSD-15/SA1/H/INGO/411,3447,7589,4500,4815,20351,2362,2711,1235,1170,7478
19,South Sudan,2,2015,SSD-15/SA1/P/INGO/419,1285,745,530,590,3150,870,636,1020,572,3098
19,South Sudan,2,2015,SSD-15/SA1/P/UN/420,0,2400,0,3600,6000,0,2150,0,3700,5850
19,South Sudan,2,2015,SSD-15/SA1/FSL/NGO/423,5272,9496,3515,4069,22352,5184,9531,3532,4418,22665
19,South Sudan,2,2015,SSD-15/SA1/H/UN/426,100000,420000,50000,60000,630000,97200,421000,58000,75000,651200
19,South Sudan,2,2015,SSD-15/HSS10/SA1/CCCM/UN/491,5219,10719,13769,14011,43718,16806,34219,43026,43029,137080
19,South Sudan,1,2015,SSD-15/HSS10/RA1/P/UN/492,0,0,2850,150,3000,0,0,1750,5,1755
19,South Sudan,1,2015,SSD-15/HSS10/RA2/L/UN/502,23,0,0,0,23,23,0,0,0,23
19,South Sudan,2,2015,SSD-15/HSS10/SA2/H/NGO/504,22400,29000,12460,12460,76320,32277,47405,30016,31232,140930
19,South Sudan,2,2015,SSD-15/HSS10/SA2/N/NGO/506,482,1125,678,706,2991,401,6724,6031,5718,18874
19,South Sudan,2,2015,SSD-15/HSS10/SA2/L/UN/507,40,0,0,0,40,35,0,0,0,35
19,South Sudan,2,2015,SSD-15/HSS10/SA2/E/NGO/509,129,48,4387,3564,8128,129,48,4387,3564,8128
19,South Sudan,2,2015,SSD-15/HSS10/SA2/FSL/INGO/510,10488,19249,3885,6176,39798,23044,23044,28805,40327,115220
19,South Sudan,2,2015,SSD-15/HSS10/SA2/FSL/NGO/511,41425,48835,0,0,90260,35886,42468,0,0,78354
19,South Sudan,2,2015,SSD-15/HSS10/SA2/L/UN/512,80,0,0,0,80,80,0,0,0,80
19,South Sudan,2,2015,SSD-15/HSS10/SA2/H/UN/513,39552,42848,10094,10506,103000,50581,67311,28971,27784,174647
19,South Sudan,2,2015,SSD-15/HSS10/SA2/N/INGO/514,1052,11543,7160,7340,27095,1741,14631,12578,12868,41818
19,South Sudan,2,2015,SSD-15/HSS10/SA2/WASH/NGO/515,1500,2500,2000,2260,8260,1200,1800,1500,1980,6480
19,South Sudan,2,2015,SSD-15/HSS10/SA2/NFI/UN/516,8298,13830,22820,24202,69150,8714,14523,23963,25415,72615
19,South Sudan,2,2015,SSD-15/HSS10/SA2/N/INGO/517,60,4139,7162,8807,20168,0,6637,14673,13871,35181
19,South Sudan,2,2015,SSD-15/HSS10/SA2/CCCM/UN/518,74928,74928,149856,168588,468300,89860,89860,179720,202190,561630
19,South Sudan,2,2015,SSD-15/HSS10/SA2/H/INGO/519,13727,20189,9464,10928,54308,14918,15929,11804,11914,54565
19,South Sudan,2,2015,SSD-15/HSS10/SA2/WASH/UN/520,2739,8306,9227,9728,30000,3821,8175,9412,9945,31353
19,South Sudan,2,2015,SSD-15/HSS10/SA2/H/UN/523,5000,30000,500,1000,36500,5100,30500,700,1200,37500
19,South Sudan,2,2015,SSD-15/HSS10/SA2/N/INGO/526,65,8706,428,445,9644,171,3957,96,99,4323
19,South Sudan,2,2015,SSD-15/HSS10/SA2/FSL/NGO/527,6500,8500,0,0,15000,6000,9000,0,0,15000
19,South Sudan,2,2015,SSD-15/HSS10/SA2/H/INGO/528,7839,8159,2169,2084,20251,10979,14255,4567,4837,34638
19,South Sudan,2,2015,SSD-15/HSS10/SA2/H/NGO/529,10957,22809,5950,5650,45366,8818,18206,6497,7513,41034
19,South Sudan,2,2015,SSD-15/HSS10/SA2/N/INGO/530,214,2340,4986,5190,12730,119,2841,6543,6810,16313
19,South Sudan,2,2015,SSD-15/HSS10/SA2/H/INGO/531,7679,23079,3871,4032,38661,3405,4365,2038,2123,11931
19,South Sudan,2,2015,SSD-15/HSS10/SA2/WASH/NGO/535,6152,6483,6762,8553,27950,8030,8165,7931,7957,32083
19,South Sudan,2,2015,SSD-15/HSS10/SA2/FSL/UN/536,9000,12000,4500,4500,30000,16950,22600,8475,8475,56500
19,South Sudan,2,2015,SSD-15/HSS10/SA2/E/NGO/539,60,40,2415,2755,5270,75,25,2368,2802,5270
19,South Sudan,2,2015,SSD-15/HSS10/SA2/E/NGO/543,93,93,3140,3140,6466,460,550,4260,4676,9946
19,South Sudan,2,2015,SSD-15/HSS10/SA2/N/NGO/545,372,1579,2010,2010,5971,457,7387,3292,2344,13480
19,South Sudan,2,2015,SSD-15/HSS10/SA2/H/NGO/547,3425,3290,910,875,8500,1200,2500,1000,950,5650
19,South Sudan,2,2015,SSD-15/HSS10/SA2/H/NGO/548,16200,18974,3133,3261,41568,13250,18500,3600,3590,38940
19,South Sudan,2,2015,SSD-15/HSS10/SA2/H/NGO/549,34920,39746,36940,37426,149032,12000,15000,6020,5220,38240
19,South Sudan,2,2015,SSD-15/HSS10/SA2/WASH/NGO/550,3195,5310,2355,4140,15000,3185,5298,2378,4139,15000
19,South Sudan,2,2015,SSD-15/HSS10/SA2/WASH/NGO/558,4720,10680,4000,5600,25000,3021,6835,2560,3584,16000
19,South Sudan,2,2015,SSD-15/HSS10/SA2/WASH/INGO/559,10625,10625,10200,11050,42500,9518,14669,13745,13745,51677
19,South Sudan,2,2015,SSD-15/HSS10/SA2/P/NGO/566,150,850,350,350,1700,644,1646,534,1276,4100
19,South Sudan,2,2015,SSD-15/HSS10/SA2/H/UN/570,73500,76500,0,0,150000,85753,82391,0,0,168144
19,South Sudan,2,2015,SSD-15/HSS10/SA2/N/NGO/575,1500,2368,7790,7618,19276,1376,1878,6351,6917,16522
19,South Sudan,2,2015,SSD-15/HSS10/SA2/WASH/INGO/579,6666,6667,13333,13334,40000,8267,13672,11563,9716,43218
19,South Sudan,2,2015,SSD-15/HSS10/SA2/WASH/INGO/581,19999,26873,32622,33427,112921,29654,41434,43088,44972,159148
19,South Sudan,2,2015,SSD-15/HSS10/SA2/WASH/INGO/582,1800,2200,2800,3200,10000,3097,5516,1623,3906,14142
19,South Sudan,2,2015,SSD-15/HSS10/SA2/N/INGO/583,7231,30450,37563,41148,116392,10616,124548,58378,63243,256785
19,South Sudan,2,2015,SSD-15/HSS10/SA2/N/NGO/586,300,1450,2665,2610,7025,63,583,3014,3596,7256
19,South Sudan,2,2015,SSD-15/HSS10/SA2/NFI/NGO/589,1200,1420,1140,1050,4810,3500,6220,4400,3800,17920
19,South Sudan,2,2015,SSD-15/HSS10/SA2/E/NGO/593,400,600,2500,2500,6000,500,161,3750,3783,8194
19,South Sudan,2,2015,SSD-15/HSS10/SA2/H/NGO/596,6307,17619,22814,24627,71367,8665,12812,14896,14287,50660
19,South Sudan,2,2015,SSD-15/HSS10/SA2/FSL/INGO/597,4000,8600,1000,4400,18000,4916,8967,2862,2405,19150
19,South Sudan,2,2015,SSD-15/HSS10/SA2/WASH/UN/598,8499,8227,8867,9081,34674,8211,7948,8567,8774,33500
19,South Sudan,2,2015,SSD-15/HSS10/SA2/P/NGO/600,0,0,228,252,480,10,30,228,252,520
19,South Sudan,2,2015,SSD-15/HSS10/SA2/E/NGO/603,210,240,3610,3620,7680,174,171,8057,5381,13783
19,South Sudan,2,2015,SSD-15/HSS10/SA2/WASH/NGO/605,13236,15884,9530,14295,52945,13236,15884,9530,14295,52945
19,South Sudan,2,2015,SSD-15/HSS10/SA2/N/INGO/607,471,8325,9651,9886,28333,38,11362,12951,13023,37374
19,South Sudan,2,2015,SSD-15/HSS10/SA2/P/UN/608,600,4000,1000,2400,8000,449,4917,960,3496,9822
19,South Sudan,2,2015,SSD-15/HSS10/SA2/NFI/INGO/609,6000,6500,6000,6500,25000,8788,12367,10061,13411,44627
19,South Sudan,2,2015,SSD-15/HSS10/SA2/P/NGO/613,107,235,2740,2660,5742,120,290,3600,3150,7160
19,South Sudan,2,2015,SSD-15/HSS10/SA2/NFI/INGO/614,11007,15412,5040,12576,44035,15680,15383,18575,18700,68338
19,South Sudan,2,2015,SSD-15/HSS10/SA2/FSL/NGO/616,7000,5000,1500,1500,15000,8592,4933,0,0,13525
19,South Sudan,2,2015,SSD-15/HSS10/SA2/WASH/INGO/617,1786,2143,3428,5143,12500,4200,4200,3300,3300,15000
19,South Sudan,2,2015,SSD-15/HSS10/SA2/CCS/UN/618,40,40,0,20,100,0,0,0,0,0
19,South Sudan,2,2015,SSD-15/HSS10/SA2/P/UN/619,0,0,600,600,1200,0,0,1154,870,2024
19,South Sudan,2,2015,SSD-15/HSS10/SA2/H/INGO/620,22361,21485,5944,5710,55500,30179,41898,15758,15538,103373
19,South Sudan,2,2015,SSD-15/HSS10/SA2/WASH/INGO/621,3762,7726,9925,10099,31512,12783,15851,11249,11249,51132
19,South Sudan,2,2015,SSD-15/HSS10/SA2/N/INGO/626,164,1900,5690,6164,13918,190,2402,3953,4354,10899
19,South Sudan,2,2015,SSD-15/HSS10/SA2/NFI/INGO/628,3755,6627,5743,5965,22090,5000,6000,5000,6000,22000
19,South Sudan,2,2015,SSD-15/HSS10/SA2/N/INGO/630,530,35705,10563,9751,56549,1101,46250,14403,15602,77356
19,South Sudan,2,2015,SSD-15/HSS10/SA2/L/UN/631,250,0,0,0,250,233,0,0,0,233
19,South Sudan,2,2015,SSD-15/HSS10/SA2/WASH/INGO/632,15600,15000,15600,13800,60000,6680,13599,10101,11004,41384
19,South Sudan,2,2015,SSD-15/HSS10/SA2/CCCM/INGO/635,8315,6991,7731,7865,30902,8041,6966,7577,7697,30281
19,South Sudan,2,2015,SSD-15/HSS10/SA2/FSL/INGO/638,15000,15000,3000,3000,36000,15000,15000,3000,3000,36000
19,South Sudan,2,2015,SSD-15/HSS10/SA2/FSL/NGO/640,6000,8000,2000,2000,18000,6000,8000,2000,2000,18000
19,South Sudan,2,2015,SSD-15/HSS10/SA2/N/INGO/642,328,8900,9337,9405,27970,7474,27729,27270,26680,89153
19,South Sudan,2,2015,SSD-15/HSS10/SA2/H/INGO/643,10551,15825,13187,13187,52750,24825,44686,16228,16393,102132
19,South Sudan,2,2015,SSD-15/HSS10/SA2/H/UN/651,0,6800,39984,43316,90100,0,10083,36873,39945,86901
19,South Sudan,2,2015,SSD-15/HSS10/SA2/NFI/INGO/652,10300,14500,16900,16300,58000,16092,18453,7110,7726,49381
19,South Sudan,2,2015,SSD-15/HSS10/SA2/N/INGO/654,100,3971,11033,11066,26170,58,14328,10231,11017,35634
19,South Sudan,1,2015,SSD-15/HSS10/RA3/L/UN/655,80,0,0,0,80,80,0,0,0,80
19,South Sudan,1,2015,SSD-15/HSS10/RA3/L/UN/656,40,0,0,0,40,44,0,0,0,44
19,South Sudan,1,2015,SSD-15/HSS10/RA3/L/UN/657,250,0,0,0,250,248,0,0,0,248
19,South Sudan,1,2015,SSD-15/HSS10/RA3/CCCM/INGO/659,30881,62096,71584,72981,237542,30692,57517,66496,68388,223093
19,South Sudan,1,2015,SSD-15/HSS10/RA4/H/NGO/661,3000,3500,1500,1510,9510,1781,2418,1503,1396,7098
19,South Sudan,1,2015,SSD-15/HSS10/RA4/H/INGO/662,4119,6898,5537,5726,22280,3007,5554,5423,5838,19822
19,South Sudan,1,2015,SSD-15/HSS10/RA4/N/NGO/663,3000,5000,3920,4080,16000,2437,5372,3801,4200,15810
19,South Sudan,1,2015,SSD-15/HSS10/RA4/MA/INGO/664,2000,2650,3950,4600,13200,1985,3729,5369,5177,16260
19,South Sudan,1,2015,SSD-15/HSS10/RA4/H/INGO/666,14242,19212,7460,6886,47800,42411,53014,25494,25488,146407
19,South Sudan,1,2015,SSD-15/HSS10/RA4/WASH/INGO/667,2629,3943,8213,8215,23000,5404,8804,9389,10752,34349
19,South Sudan,1,2015,SSD-15/HSS10/RA4/E/INGO/668,90,60,2800,1400,4350,193,97,23736,12851,36877
19,South Sudan,1,2015,SSD-15/HSS10/RA5/CCCM/UN/669,70,70,0,0,140,112,14,0,0,126
19,South Sudan,2,2016,SSD-16/HSS10/SA1/WASH/NGO/671,6500,9600,4200,4700,25000,5100,5800,4300,4400,19600
19,South Sudan,2,2016,SSD-16/HSS10/SA1/P/UN/672,45,5075,0,3500,8620,45,6575,0,4000,10620
19,South Sudan,2,2016,SSD-16/HSS10/SA1/E/NGO/673,785,974,2016,1959,5734,643,753,1865,1653,4914
19,South Sudan,2,2016,SSD-16/HSS10/SA1/N/NGO/675,500,1351,880,780,3511,444,4972,7349,6732,19497
19,South Sudan,2,2016,SSD-16/HSS10/SA1/H/INGO/678,11700,11250,11700,10350,45000,15380,14788,15380,13605,59153
19,South Sudan,2,2016,SSD-16/HSS10/SA1/WASH/INGO/679,5900,11800,5400,6900,30000,2458,4917,2250,2875,12500
19,South Sudan,2,2016,SSD-16/HSS10/SA1/WASH/NGO/683,2415,7015,2500,6100,18030,4732,7018,4600,4806,21156
19,South Sudan,2,2016,SSD-16/HSS10/SA1/H/UN/685,33183,34537,6797,7074,81591,33707,66501,102850,112880,315938
19,South Sudan,2,2016,SSD-16/HSS10/SA1/L/UN/686,80,0,0,0,80,0,0,0,58,58
19,South Sudan,2,2016,SSD-16/HSS10/SA1/NFI/UN/687,4500,6600,9000,9900,30000,4556,6682,9112,10023,30373
19,South Sudan,2,2016,SSD-16/HSS10/SA1/L/UN/688,14000,0,0,0,14000,19066,0,0,0,19066
19,South Sudan,2,2016,SSD-16/HSS10/SA1/WASH/NGO/690,3200,3552,2900,3100,12752,3169,3705,3075,3251,13200
19,South Sudan,2,2016,SSD-16/HSS10/SA1/WASH/NGO/692,6200,10850,6200,7750,31000,7800,13650,7800,9750,39000
19,South Sudan,2,2016,SSD-16/HSS10/SA1/H/NGO/693,10957,22809,5950,5650,45366,4444,7162,3899,6339,21844
19,South Sudan,2,2016,SSD-16/HSS10/SA1/NFI/NGO/694,3670,4880,4150,4570,17270,3670,4880,4150,4570,17270
19,South Sudan,2,2016,SSD-16/HSS10/SA1/E/NGO/695,77,48,1500,1850,3475,110,15,1500,1850,3475
19,South Sudan,2,2016,SSD-16/HSS10/SA1/WASH/NGO/698,5822,6627,5706,6327,24482,6540,9073,6320,7539,29472
19,South Sudan,2,2016,SSD-16/HSS10/SA1/WASH/INGO/701,1459,1581,2480,2480,8000,3939,4061,0,0,8000
19,South Sudan,2,2016,SSD-16/HSS10/SA1/FSL/INGO/702,7375,7625,7375,7625,30000,1955,3045,10161,14839,30000
19,South Sudan,2,2016,SSD-16/HSS10/SA1/N/INGO/704,100,857,2067,2152,5176,298,990,2022,1984,5294
19,South Sudan,2,2016,SSD-16/HSS10/SA1/FSL/UN/706,50000,70000,50000,50000,220000,66041,88055,60538,60538,275172
19,South Sudan,2,2016,SSD-16/HSS10/SA1/NFI/UN/709,25000,27000,23000,25000,100000,21373,23154,26122,28299,98948
19,South Sudan,2,2016,SSD-16/HSS10/SA1/N/UN/711,12010,22500,53190,58649,146349,0,32750,29959,31182,93891
19,South Sudan,2,2016,SSD-16/HSS10/SA1/NFI/INGO/712,6600,9900,8250,8250,33000,35309,46218,13114,12206,106847
19,South Sudan,2,2016,SSD-16/HSS10/SA1/N/NGO/713,150,869,1085,1130,3234,40,783,1094,1139,3056
19,South Sudan,2,2016,SSD-16/HSS10/SA1/E/NGO/715,470,520,4610,4620,10220,184,153,4812,4466,9615
19,South Sudan,2,2016,SSD-16/HSS10/SA1/N/UN/721,0,0,5635,5865,11500,0,0,7057,7645,14702
19,South Sudan,2,2016,SSD-16/HSS10/SA1/CCCM/INGO/722,15660,27976,29508,31311,104455,15660,27976,29508,31311,104455
19,South Sudan,2,2016,SSD-16/HSS10/SA1/E/NGO/724,1000,2000,1500,2000,6500,1750,2600,3800,4000,12150
19,South Sudan,2,2016,SSD-16/HSS10/SA1/NFI/INGO/725,2662,4776,4526,4526,16490,3556,4823,4444,4616,17439
19,South Sudan,2,2016,SSD-16/HSS10/SA1/FSL/INGO/728,4600,5250,0,0,9850,4316,5019,0,0,9335
19,South Sudan,2,2016,SSD-16/HSS10/SA1/H/INGO/731,25077,26101,6666,6938,64782,9865,10267,6510,6776,33418
19,South Sudan,2,2016,SSD-16/HSS10/SA1/P/UN/732,100,100,700,800,1700,143,124,2186,2081,4534
19,South Sudan,2,2016,SSD-16/HSS10/SA1/N/INGO/733,0,313,670,698,1681,0,288,757,835,1880
19,South Sudan,2,2016,SSD-16/HSS10/SA1/N/NGO/736,3000,5300,2860,3640,14800,2998,3238,2960,3940,13136
19,South Sudan,2,2016,SSD-16/HSS10/SA1/WASH/INGO/737,6000,7000,6000,6000,25000,10751,20210,11809,12660,55430
19,South Sudan,2,2016,SSD-16/HSS10/SA1/H/INGO/738,21066,42134,8400,8400,80000,38910,59847,39177,42550,180484
19,South Sudan,2,2016,SSD-16/HSS10/SA1/FSL/INGO/739,2000,3000,0,0,5000,3077,1916,0,0,4993
19,South Sudan,2,2016,SSD-16/HSS10/SA1/WASH/INGO/747,1652,1719,1298,1351,6020,1438,1497,1130,1176,5241
19,South Sudan,2,2016,SSD-16/HSS10/SA1/P/NGO/748,500,3400,500,1000,5400,900,5400,800,2500,9600
19,South Sudan,2,2016,SSD-16/HSS10/SA1/H/UN/750,35000,31000,30000,29000,125000,71641,76648,33816,35191,217296
19,South Sudan,2,2016,SSD-16/HSS10/SA1/WASH/INGO/751,6197,5183,4638,4415,20433,6197,5183,4638,4415,20433
19,South Sudan,2,2016,SSD-16/HSS10/SA1/L/UN/754,80,0,0,0,80,77,0,0,0,77
19,South Sudan,2,2016,SSD-16/HSS10/SA1/P/INGO/755,1725,2300,3450,4025,11500,2505,3821,4318,4166,14810
19,South Sudan,2,2016,SSD-16/HSS10/SA1/FSL/INGO/759,16000,18200,25000,26000,85200,12500,14600,16800,18600,62500
19,South Sudan,2,2016,SSD-16/HSS10/SA1/WASH/NGO/761,2050,2475,2075,2400,9000,3234,2826,5642,4987,16689
19,South Sudan,2,2016,SSD-16/HSS10/SA1/NFI/INGO/763,2000,1600,1300,1360,6260,3000,2000,500,300,5800
19,South Sudan,2,2016,SSD-16/HSS10/SA1/NFI/NGO/765,8000,12000,5000,5000,30000,4800,7700,4400,4600,21500
19,South Sudan,2,2016,SSD-16/HSS10/SA1/H/NGO/766,23700,28300,6600,6400,65000,14970,21814,7297,8418,52499
19,South Sudan,2,2016,SSD-16/HSS10/SA1/N/UN/767,0,9725,0,0,9725,0,7756,0,0,7756
19,South Sudan,2,2016,SSD-16/HSS10/SA1/N/NGO/771,612,5476,3636,3654,13378,212,1904,5224,5345,12685
19,South Sudan,2,2016,SSD-16/HSS10/SA1/H/NGO/773,8872,31544,24644,33518,98578,7571,18592,18994,19701,64858
19,South Sudan,2,2016,SSD-16/HSS10/SA1/P/NGO/774,300,3000,300,1400,5000,858,2255,776,1255,5144
19,South Sudan,2,2016,SSD-16/HSS10/SA1/H/INGO/775,26165,21933,25011,23087,96196,25863,29635,14150,15383,85031
19,South Sudan,2,2016,SSD-16/HSS10/SA1/NFI/INGO/776,7200,7800,7200,7800,30000,8575,9753,8843,10060,37231
19,South Sudan,2,2016,SSD-16/HSS10/SA1/P/INGO/778,4776,12631,1912,8360,27679,8997,17631,2012,9360,38000
19,South Sudan,2,2016,SSD-16/HSS10/SA1/WASH/NGO/779,1125,2000,2875,2000,8000,2032,3687,3029,3402,12150
19,South Sudan,2,2016,SSD-16/HSS10/SA1/L/UN/780,80,0,0,0,80,87,0,0,0,87
19,South Sudan,2,2016,SSD-16/HSS10/SA1/FSL/NGO/783,4800,7200,0,0,12000,5000,7000,0,0,12000
19,South Sudan,2,2016,SSD-16/HSS10/SA1/H/INGO/784,43182,43059,7074,6801,100116,25623,44064,15628,14075,99390
19,South Sudan,2,2016,SSD-16/HSS10/SA1/ETC/UN/785,120,0,0,0,120,120,0,0,0,120
19,South Sudan,2,2016,SSD-16/HSS10/SA1/CCCM/INGO/786,7920,6835,7692,7829,30276,4370,5190,4900,5580,20040
19,South Sudan,2,2016,SSD-16/HSS10/SA1/E/INGO/788,175,117,4096,2754,7142,359,135,5483,4836,10813
19,South Sudan,2,2016,SSD-16/HSS10/SA1/WASH/INGO/792,5500,7700,4800,7000,25000,7293,6938,4432,4309,22972
19,South Sudan,2,2016,SSD-16/HSS10/SA1/WASH/UN/794,4412,30416,9761,18411,63000,13981,96384,30932,58342,199639
19,South Sudan,2,2016,SSD-16/HSS10/SA1/N/INGO/795,60,866,11002,11451,23379,133,2528,9883,10326,22870
19,South Sudan,2,2016,SSD-16/HSS10/SA1/E/INGO/797,1000,550,2000,2200,5750,164,56,4176,1864,6260
19,South Sudan,2,2016,SSD-16/HSS10/SA1/WASH/INGO/804,916,3254,1248,1152,6570,908,3517,1208,1522,7155
19,South Sudan,2,2016,SSD-16/HSS10/SA1/H/UN/806,61065,54435,15435,19065,150000,74163,73390,19992,20808,188353
19,South Sudan,2,2016,SSD-16/HSS10/SA1/E/UN/807,150,50,12000,8000,20200,150,50,12000,8000,20200
19,South Sudan,2,2016,SSD-16/HSS10/SA1/N/INGO/810,5,1013,2576,2715,6309,5,363,1720,1913,4001
19,South Sudan,2,2016,SSD-16/HSS10/SA1/N/INGO/811,10,6867,6667,6941,20485,1,5619,4712,4338,14670
19,South Sudan,2,2016,SSD-16/HSS10/SA1/NFI/INGO/812,24000,29760,21120,21120,96000,24200,26449,14058,13963,78670
19,South Sudan,2,2016,SSD-16/HSS10/SA1/WASH/UN/813,21800,24700,23800,24700,95000,27800,30000,29100,30000,116900
19,South Sudan,2,2016,SSD-16/HSS10/SA1/WASH/UN/814,6825,9750,7800,8125,32500,7035,10050,8040,8375,33500
19,South Sudan,2,2016,SSD-16/HSS10/SA1/H/NGO/815,11700,20328,12120,12042,56190,12534,14139,5816,6346,38835
19,South Sudan,2,2016,SSD-16/HSS10/SA1/H/INGO/817,19059,30023,9923,10243,69248,35596,40114,18072,17582,111364
19,South Sudan,2,2016,SSD-16/HSS10/SA1/N/INGO/823,0,898,1193,1241,3332,0,931,520,781,2232
19,South Sudan,2,2016,SSD-16/HSS10/SA1/P/NGO/824,14,41,661,842,1558,53,58,1271,1192,2574
19,South Sudan,2,2016,SSD-16/HSS10/SA1/N/INGO/825,640,11326,9884,10708,32558,1821,27461,10451,12853,52586
19,South Sudan,2,2016,SSD-16/HSS10/SA1/WASH/INGO/827,2112,2112,2976,2400,9600,3450,3450,3795,3105,13800
19,South Sudan,2,2016,SSD-16/HSS10/SA1/NFI/INGO/828,9000,10000,9500,10500,39000,13135,13363,11030,13059,50587
19,South Sudan,2,2016,SSD-16/HSS10/SA1/H/INGO/829,11670,18856,9976,8168,48670,15779,24670,11934,9764,62147
19,South Sudan,2,2016,SSD-16/HSS10/SA1/NFI/INGO/831,12718,13172,9538,9993,45421,10808,16601,15667,15541,58617
19,South Sudan,2,2016,SSD-16/HSS10/SA1/FSL/INGO/839,3696,4704,924,1176,10500,9831,10579,428,328,21166
19,South Sudan,2,2016,SSD-16/HSS10/SA1/P/UN/842,1595,2698,1666,1525,7484,1864,3559,1578,1351,8352
19,South Sudan,2,2016,SSD-16/HSS10/SA1/FSL/INGO/843,1440,2160,2160,3240,9000,1196,1794,1793,2690,7473
19,South Sudan,2,2016,SSD-16/HSS10/SA1/WASH/INGO/845,6402,12111,3498,3789,25800,12147,15684,11593,10177,49601
19,South Sudan,2,2016,SSD-16/HSS10/SA1/N/INGO/847,5244,28218,30948,33527,97937,9685,81842,31857,33981,157365
19,South Sudan,2,2016,SSD-16/HSS10/SA1/E/NGO/848,350,650,1850,2150,5000,94,14,4022,3978,8108
19,South Sudan,2,2016,SSD-16/HSS10/SA1/P/INGO/850,1237,9673,645,5000,16555,2865,14435,3566,11615,32481
19,South Sudan,2,2016,SSD-16/HSS10/SA1/P/NGO/853,150,170,485,485,1290,214,138,688,593,1633
19,South Sudan,2,2016,SSD-16/HSS10/SA1/FSL/INGO/859,10040,4140,1355,1000,16535,29304,32057,30584,31084,123029
19,South Sudan,2,2016,SSD-16/HSS10/SA1/E/INGO/862,909,1054,4139,4121,10223,3301,3060,5110,1706,13177
19,South Sudan,2,2016,SSD-16/HSS10/SA1/FSL/INGO/865,26800,20000,0,0,46800,17322,29466,0,0,46788
19,South Sudan,2,2016,SSD-16/HSS10/SA1/N/INGO/869,416,4158,5472,5696,15742,3076,4614,5814,6657,20161
19,South Sudan,2,2016,SSD-16/HSS10/SA1/WASH/INGO/870,18954,20536,17042,18468,75000,15100,24159,19847,24728,83834
19,South Sudan,2,2016,SSD-16/HSS10/SA1/E/INGO/875,40,14,1740,1160,2954,52,2,1697,989,2740
19,South Sudan,2,2016,SSD-16/HSS10/SA1/CCCM/INGO/880,7920,6835,7692,7829,30276,9005,10200,11018,10627,40850
19,South Sudan,2,2016,SSD-16/HSS10/SA1/CCCM/INGO/881,18760,27086,26914,27939,100699,18760,27086,26914,27939,100699
19,South Sudan,1,2016,SSD-16/HSS10/RA1/NFI/UN/3150,20458,22164,20458,18884,81964,25662,30581,25662,25020,106925
19,South Sudan,1,2016,SSD-16/HSS10/RA1/P/UN/3155,8580,10663,5000,5400,29643,15368,16722,6125,6029,44244
19,South Sudan,1,2016,SSD-16/HSS10/RA1/H/UN/3156,16806,17192,4428,4609,43035,24059,28098,20015,43046,115218
19,South Sudan,1,2016,SSD-16/HSS10/RA1/N/UN/3157,0,1880,1123,1217,4220,0,2613,2452,2765,7830
19,South Sudan,1,2016,SSD-16/HSS10/RA1/P/INGO/3160,600,3800,900,2800,8100,1851,4730,2028,3739,12348
19,South Sudan,1,2016,SSD-16/HSS10/RA1/H/UN/3161,17400,21750,0,20000,59150,17500,21000,3000,20500,62000
19,South Sudan,1,2016,SSD-16/HSS10/RA1/H/UN/3162,0,3000,14382,13818,31200,0,3404,19982,17484,40870
19,South Sudan,1,2016,SSD-16/HSS10/RA1/N/NGO/3163,7000,10000,10400,9600,37000,2199,11000,7106,6611,26916
19,South Sudan,1,2016,SSD-16/HSS10/RA1/WASH/INGO/3164,9216,20800,4792,5192,40000,9887,13104,16809,18209,58009
19,South Sudan,1,2016,SSD-16/HSS10/RA1/E/INGO/3165,16,7,1200,800,2023,111,49,1886,2001,4047
19,South Sudan,1,2016,SSD-16/HSS10/RA1/H/UN/3166,23205,22295,15435,19065,80000,21390,19765,12345,17904,71404
19,South Sudan,2,2016,SSD-16/HSS10/SA2/WASH/NGO/3395,3943,5130,3929,5080,18082,4682,5718,4826,6127,21353
19,South Sudan,2,2016,SSD-16/HSS10/SA2/E/NGO/3402,100,100,4900,4900,10000,190,80,4806,4441,9517
19,South Sudan,2,2016,SSD-16/HSS10/SA2/FSL/INGO/3408,5000,5000,10000,10000,30000,14327,16515,23896,28873,83611
19,South Sudan,2,2016,SSD-16/HSS10/SA2/H/NGO/3410,15000,20000,7000,7500,49500,12500,18000,6300,7250,44050
19,South Sudan,2,2016,SSD-16/HSS10/SA2/NFI/INGO/3411,10145,11170,9787,10898,42000,8612,10602,13685,14132,47031
19,South Sudan,2,2016,SSD-16/HSS10/SA2/E/INGO/3413,150,50,5530,3530,9260,179,99,7800,4776,12854
19,South Sudan,2,2016,SSD-16/HSS10/SA2/P/INGO/3414,100,200,2000,2000,4300,100,200,3500,3500,7300
19,South Sudan,2,2016,SSD-16/HSS10/SA2/H/NGO/3417,21480,82000,8470,8050,120000,9070,24282,7652,6874,47878
19,South Sudan,2,2016,SSD-16/HSS10/SA2/E/NGO/3426,0,0,5600,6678,12278,480,361,6684,5614,13139
19,South Sudan,2,2016,SSD-16/HSS10/SA2/P/NGO/3427,350,700,1200,1200,3450,557,2460,2445,3042,8504
19,South Sudan,2,2016,SSD-16/HSS10/SA2/N/NGO/3429,197,4336,2505,2055,9093,292,9456,12805,12785,35338
19,South Sudan,2,2016,SSD-16/HSS10/SA2/WASH/NGO/3431,4500,12000,5000,4500,26000,4500,12000,5000,4500,26000
19,South Sudan,2,2016,SSD-16/HSS10/SA2/WASH/NGO/3437,10259,17953,10260,12824,51296,8050,11200,7088,8662,35000
19,South Sudan,2,2016,SSD-16/HSS10/SA2/H/NGO/3441,15990,19228,2485,2555,40258,11154,16553,2852,2718,33277
19,South Sudan,2,2016,SSD-16/HSS10/SA2/WASH/NGO/3442,3750,5252,2248,3750,15000,3914,5620,2602,3814,15950
19,South Sudan,2,2016,SSD-16/HSS10/SA2/E/NGO/3443,191,104,4245,2980,7520,175,85,4245,2980,7485
19,South Sudan,2,2016,SSD-16/HSS10/SA2/H/UN/3445,30400,38000,37620,45980,152000,30500,39000,37500,46000,153000
19,South Sudan,2,2016,SSD-16/HSS10/SA2/P/NGO/3447,371,810,490,591,2262,345,2370,584,764,4063
19,South Sudan,2,2016,SSD-16/HSS10/SA2/NFI/INGO/3449,10332,14252,15985,17032,57601,18586,23707,25221,26020,93534
19,South Sudan,2,2016,SSD-16/HSS10/SA2/P/NGO/3450,2000,2500,2550,2550,9600,1872,3007,2827,2586,10292
19,South Sudan,2,2016,SSD-16/HSS10/SA2/NFI/NGO/3453,8000,11000,9000,9000,37000,14230,17516,0,0,31746
19,South Sudan,2,2016,SSD-16/HSS10/SA2/H/NGO/3455,28550,31976,25374,28300,114200,28449,32624,25317,32802,119192
19,South Sudan,2,2016,SSD-16/HSS10/SA2/P/INGO/3456,500,1000,500,1000,3000,727,764,901,1276,3668
19,South Sudan,2,2016,SSD-16/HSS10/SA2/WASH/NGO/3457,3000,4000,5000,6000,18000,3390,5940,7700,7242,24272
19,South Sudan,2,2016,SSD-16/HSS10/SA2/N/INGO/3458,400,6391,7000,7219,21010,381,3331,4369,5170,13251
19,South Sudan,2,2016,SSD-16/HSS10/SA2/NFI/INGO/3459,14695,14188,11148,10641,50672,18399,18073,15860,16069,68401
19,South Sudan,2,2016,SSD-16/HSS10/SA2/N/NGO/3461,2500,1500,3500,4200,11700,1955,1603,2590,3465,9613
19,South Sudan,2,2016,SSD-16/HSS10/SA2/H/NGO/3462,9836,10746,9124,12617,42323,8446,12490,2493,2542,25971
19,South Sudan,2,2016,SSD-16/HSS10/SA2/CCCM/INGO/3469,7731,16179,17800,18473,60183,14083,16476,11247,13430,55236
19,South Sudan,2,2016,SSD-16/HSS10/SA2/WASH/NGO/3471,2250,4000,5750,4000,16000,2336,4126,5732,4424,16618
19,South Sudan,2,2016,SSD-16/HSS10/SA2/WASH/NGO/3472,1200,1700,1500,1600,6000,1634,4401,531,730,7296
19,South Sudan,2,2016,SSD-16/HSS10/SA2/L/UN/3479,6000,0,0,0,6000,5786,0,0,0,5786
19,South Sudan,2,2016,SSD-16/HSS10/SA2/N/NGO/3481,498,6075,15479,15530,37582,539,8326,23516,23540,55921
19,South Sudan,2,2016,SSD-16/HSS10/SA2/H/INGO/3493,5605,4936,6464,7003,24008,9343,12656,6457,7083,35539
19,South Sudan,2,2016,SSD-16/HSS10/SA2/P/UN/3495,10,2520,0,2500,5030,10,2550,0,2470,5030
19,South Sudan,2,2016,SSD-16/HSS10/SA2/NFI/INGO/3508,600,1200,2400,2600,6800,206,334,618,1002,2160
19,South Sudan,2,2016,SSD-16/HSS10/SA2/P/INGO/3514,736,900,322,271,2229,868,1098,163,110,2239
19,South Sudan,2,2016,SSD-16/HSS10/SA2/L/UN/3517,0,80,0,0,80,0,84,0,0,84
19,South Sudan,2,2016,SSD-16/HSS10/SA2/WASH/UN/3520,7721,53228,17081,32220,110250,14496,99937,32070,60494,206997
19,South Sudan,2,2016,SSD-16/HSS10/SA2/P/NGO/3537,40,70,960,960,2030,40,73,2463,3439,6015
19,South Sudan,2,2016,SSD-16/HSS10/SA2/NFI/INGO/3538,4900,4900,5100,5100,20000,6520,4714,13040,9429,33703
19,South Sudan,2,2016,SSD-16/HSS10/SA2/FSL/NGO/3539,2050,2100,350,500,5000,2650,2350,0,0,5000
19,South Sudan,2,2016,SSD-16/HSS10/SA2/E/NGO/3540,120,80,2058,2142,4400,120,80,5378,2538,8116
19,South Sudan,2,2016,SSD-16/HSS10/SA2/NFI/UN/3544,18000,26400,36000,39600,120000,21588,26713,36110,40127,124538
19,South Sudan,2,2016,SSD-16/HSS10/SA2/NFI/UN/3547,5400,7920,10800,11880,36000,19053,27944,38106,41917,127020
19,South Sudan,2,2016,SSD-16/HSS10/SA2/FSL/INGO/3554,4200,8500,10353,18527,41580,3958,8011,9757,17460,39186
19,South Sudan,2,2016,SSD-16/HSS10/SA2/FSL/NGO/3555,13731,20596,28442,35307,98076,13731,20596,28442,35307,98076
19,South Sudan,2,2016,SSD-16/HSS10/SA2/N/INGO/3558,460,6415,13021,13891,33787,306,9829,13237,13880,37252
19,South Sudan,2,2016,SSD-16/HSS10/SA2/H/UN/3560,55120,50880,48880,45120,200000,55120,50880,48880,45120,200000
19,South Sudan,2,2016,SSD-16/HSS10/SA2/H/INGO/3569,8639,11452,1769,2346,24206,4991,7036,2315,2957,17299
19,South Sudan,2,2016,SSD-16/HSS10/SA2/H/UN/3570,29784,31527,13809,16258,91378,40931,61397,28337,26763,157428
19,South Sudan,2,2016,SSD-16/HSS10/SA2/P/NGO/3572,28550,31976,25374,28300,114200,19985,27179,17761,25470,90395
19,South Sudan,2,2016,SSD-16/HSS10/SA2/N/INGO/3573,0,16427,14690,19521,50638,0,0,17982,19588,37570
19,South Sudan,2,2016,SSD-16/HSS10/SA2/WASH/INGO/3574,5375,7525,3225,5375,21500,3886,4054,7324,7543,22807
19,South Sudan,2,2016,SSD-16/HSS10/SA2/FSL/NGO/3575,22000,36000,14000,27000,99000,22000,36000,14000,27000,99000
19,South Sudan,2,2016,SSD-16/HSS10/SA2/P/UN/3576,100,19120,0,26000,45220,124,19109,0,26000,45233
19,South Sudan,2,2016,SSD-16/HSS10/SA2/WASH/NGO/3583,5000,7000,1800,1200,15000,5000,7000,1800,1200,15000
19,South Sudan,2,2016,SSD-16/HSS10/SA2/E/UN/3585,310,140,15000,10000,25450,310,140,15000,10000,25450
19,South Sudan,2,2016,SSD-16/HSS10/SA2/WASH/INGO/3586,12025,13128,18864,20168,64185,11004,16556,18987,20219,66766
19,South Sudan,2,2016,SSD-16/HSS10/SA2/H/INGO/3588,28271,29425,31880,33181,122757,28217,29425,31880,33181,122703
19,South Sudan,2,2016,SSD-16/HSS10/SA2/H/INGO/3589,10516,16269,13044,10673,50502,6916,11967,27728,25899,72510
19,South Sudan,2,2016,SSD-16/HSS10/SA2/FSL/INGO/3591,3430,3430,3570,3570,14000,3430,3430,3570,3570,14000
19,South Sudan,2,2016,SSD-16/HSS10/SA2/P/INGO/3593,2474,4489,6973,10469,24405,1860,3460,2629,2864,10813
19,South Sudan,2,2016,SSD-16/HSS10/SA2/N/UN/3594,0,0,588,612,1200,0,0,3505,4200,7705
19,South Sudan,2,2016,SSD-16/HSS10/SA2/H/INGO/3595,11732,23463,4725,4725,44645,8482,15351,4068,4152,32053
19,South Sudan,2,2016,SSD-16/HSS10/SA2/E/INGO/3596,1910,1941,6851,4279,14981,924,1512,4560,2012,9008
19,South Sudan,2,2016,SSD-16/HSS10/SA2/N/INGO/3597,1511,31190,31595,31595,95891,1791,19159,18148,18148,57246
19,South Sudan,2,2016,SSD-16/HSS10/SA2/NFI/NGO/3599,5000,12500,4000,8500,30000,8766,12649,6510,8767,36692
19,South Sudan,2,2016,SSD-16/HSS10/SA2/WASH/INGO/3600,1147,4068,1560,1440,8215,2024,3029,2232,2531,9816
19,South Sudan,2,2016,SSD-16/HSS10/SA2/E/INGO/3601,82,24,2940,1960,5006,235,136,3430,1456,5257
19,South Sudan,2,2016,SSD-16/HSS10/SA2/N/INGO/3603,530,26489,32085,30826,89930,843,17516,11357,11470,41186
19,South Sudan,2,2016,SSD-16/HSS10/SA2/N/INGO/3604,0,0,12111,12889,25000,0,0,28987,29845,58832
19,South Sudan,2,2016,SSD-16/HSS10/SA2/N/INGO/3617,108,2742,4059,4397,11306,100,3354,4538,4414,12406
19,South Sudan,2,2016,SSD-16/HSS10/SA2/WASH/INGO/3618,6197,5183,4638,4415,20433,6197,5183,4638,4415,20433
19,South Sudan,2,2016,SSD-16/HSS10/SA2/FSL/INGO/3620,3780,5220,0,0,9000,2050,6950,0,0,9000
19,South Sudan,2,2016,SSD-16/HSS10/SA2/WASH/INGO/3622,1967,3933,1800,2300,10000,5031,20155,4599,5877,35662
19,South Sudan,2,2016,SSD-16/HSS10/SA2/WASH/NGO/3627,4800,5350,4200,4994,19344,2510,3350,3120,3980,12960
19,South Sudan,2,2016,SSD-16/HSS10/SA2/H/INGO/3628,32630,44690,25445,26345,129110,30792,42521,23995,24551,121859
19,South Sudan,2,2016,SSD-16/HSS10/SA2/N/INGO/3631,1500,12324,14342,14928,43094,1350,22662,16174,16311,56497
19,South Sudan,2,2016,SSD-16/HSS10/SA2/WASH/INGO/3633,1650,2550,5400,5400,15000,4078,8426,6763,7463,26730
19,South Sudan,2,2016,SSD-16/HSS10/SA2/P/UN/3635,1000,5000,4625,4625,15250,2261,4159,31361,34950,72731
19,South Sudan,2,2016,SSD-16/HSS10/SA2/H/UN/3636,78540,75460,7464,7173,168637,73450,65065,4676,6980,150171
19,South Sudan,2,2016,SSD-16/HSS10/SA2/WASH/UN/3638,7900,10710,19907,21483,60000,9785,16995,11845,32208,70833
19,South Sudan,2,2016,SSD-16/HSS10/SA2/WASH/UN/3640,37750,50000,43250,50000,181000,42200,52050,46700,52050,193000
19,South Sudan,2,2016,SSD-16/HSS10/SA2/P/INGO/3653,80,560,170,365,1175,792,1099,657,884,3432
19,South Sudan,2,2016,SSD-16/HSS10/SA2/P/INGO/3719,3000,2000,3000,2000,10000,3811,4307,5361,4964,18443
19,South Sudan,2,2016,SSD-16/HSS10/SA2/FSL/UN/3775,50000,50000,125000,125000,350000,50000,50000,125000,125000,350000
19,South Sudan,1,2016,SSD-16/HSS10/RA 2/E/UN/4437,210,90,9120,6080,15500,210,90,9120,6080,15500
19,South Sudan,1,2016,SSD-16/HSS10/RA 2/FSL/UN/4438,9120,13680,9120,13680,45600,9120,13680,9120,13680,45600
19,South Sudan,1,2016,SSD-16/HSS10/RA 2/H/UN/4439,49959,49789,58493,63368,221609,0,27601,93055,96853,217509
19,South Sudan,1,2016,SSD-16/HSS10/RA 2/H/UN/4440,55400,69250,60940,91410,277000,54800,71300,59000,94000,279100
19,South Sudan,1,2016,SSD-16/HSS10/RA 2/H/UN/4441,76500,73500,0,0,150000,76500,73500,0,0,150000
19,South Sudan,1,2016,SSD-16/HSS10/RA 2/N/UN/4442,0,0,4872,5071,9943,0,0,4872,5071,9943
19,South Sudan,1,2016,SSD-16/HSS10/RA 2/N/UN/4443,0,0,20020,20837,40857,0,0,16258,16598,32856
19,South Sudan,1,2016,SSD-16/HSS10/RA 2/P/UN/4444,0,15000,0,13500,28500,0,15296,0,13204,28500
19,South Sudan,1,2016,SSD-16/HSS10/RA 2/P/UN/4445,0,0,16250,16250,32500,0,0,25053,16027,41080
19,South Sudan,1,2016,SSD-16/HSS10/RA 2/WASH/UN/4446,8400,50400,19600,61600,140000,6573,39439,15338,48204,109554
19,South Sudan,1,2016,SSD-16/HSS10/RA 2/WASH/UN/4447,25300,28600,27500,28600,110000,26539,30000,28847,30000,115386
19,South Sudan,1,2016,SSD-16/HSS10/RA 2/NFI/UN/4453,16748,24563,33495,36844,111650,26902,31565,27647,30676,116790
19,South Sudan,2,2017,SSD-17/HSS10/SA1/WASH/NGO/5056,3000,6000,5000,7000,21000,3200,7000,5700,7500,23400
19,South Sudan,2,2017,SSD-17/HSS10/SA1/NFI/NGO/5058,7200,10800,4800,7200,30000,5236,6458,0,0,11694
19,South Sudan,2,2017,SSD-17/HSS10/SA1/WASH/NGO/5059,900,1600,800,1200,4500,1744,2000,1482,1709,6935
19,South Sudan,2,2017,SSD-17/HSS10/SA1/FSL/INGO/5060,3200,3200,5800,5800,18000,11106,12510,5940,6012,35568
19,South Sudan,2,2017,SSD-17/HSS10/SA1/L/UN/5061,240,0,0,0,240,0,0,0,0,0
19,South Sudan,2,2017,SSD-17/HSS10/SA1/WASH/INGO/5063,12217,13235,5236,5672,36360,8220,11402,4183,5794,29599
19,South Sudan,2,2017,SSD-17/HSS10/SA1/P/NGO/5064,1000,1500,3000,3000,8500,986,1467,2876,2688,8017
19,South Sudan,2,2017,SSD-17/HSS10/SA1/WASH/NGO/5065,2250,4000,5400,4350,16000,2350,4276,5900,4860,17386
19,South Sudan,2,2017,SSD-17/HSS10/SA1/WASH/NGO/5071,2110,3854,1638,2898,10500,5163,7790,5107,8112,26172
19,South Sudan,2,2017,SSD-17/HSS10/SA1/E/NGO/5073,24,16,2100,1400,3540,24,16,4749,1893,6682
19,South Sudan,2,2017,SSD-17/HSS10/SA1/N/INGO/5076,0,2152,8199,8533,18884,0,6307,3536,3966,13809
19,South Sudan,2,2017,SSD-17/HSS10/SA1/WASH/NGO/5078,5558,7257,5305,7152,25272,6091,7249,6051,6974,26365
19,South Sudan,2,2017,SSD-17/HSS10/SA1/H/INGO/5079,17118,17816,9340,10118,54392,4571,4761,34876,37783,81991
19,South Sudan,2,2017,SSD-17/HSS10/SA1/CCCM/INGO/5080,5621,8042,8462,8434,30559,5314,7062,6793,6737,25906
19,South Sudan,2,2017,SSD-17/HSS10/SA1/E/INGO/5082,314,312,3355,2745,6726,313,187,4492,3633,8625
19,South Sudan,2,2017,SSD-17/HSS10/SA1/P/INGO/5086,1200,1600,2400,2800,8000,2058,4761,4769,4683,16271
19,South Sudan,2,2017,SSD-17/HSS10/SA1/L/UN/5087,40,0,0,0,40,20,0,0,0,20
19,South Sudan,2,2017,SSD-17/HSS10/SA1/CCCM/INGO/5088,9346,14019,0,0,23365,18966,19482,0,0,38448
19,South Sudan,2,2017,SSD-17/HSS10/SA1/H/INGO/5089,3077,4936,6387,6919,21319,7544,14007,5912,6771,34234
19,South Sudan,2,2017,SSD-17/HSS10/SA1/N/INGO/5090,0,2624,5373,5970,13967,0,1323,665,657,2645
19,South Sudan,2,2017,SSD-17/HSS10/SA1/H/UN/5093,10086,15128,6982,6595,38791,5619,9567,4787,4529,24502
19,South Sudan,2,2017,SSD-17/HSS10/SA1/E/INGO/5095,100,500,1900,2100,4600,98,133,3369,1857,5457
19,South Sudan,2,2017,SSD-17/HSS10/SA1/P/INGO/5096,113,60,1575,1575,3323,918,1115,1883,1911,5827
19,South Sudan,2,2017,SSD-17/HSS10/SA1/H/NGO/5097,800,1200,400,600,3000,956,1622,1208,2051,5837
19,South Sudan,2,2017,SSD-17/HSS10/SA1/H/NGO/5098,1100,2380,2220,2720,8420,20653,16524,7753,7023,51953
19,South Sudan,2,2017,SSD-17/HSS10/SA1/FSL/INGO/5103,4062,6324,234,180,10800,4062,6324,234,180,10800
19,South Sudan,2,2017,SSD-17/HSS10/SA1/N/INGO/5104,8,3070,3990,5742,12810,8,3070,3990,5742,12810
19,South Sudan,2,2017,SSD-17/HSS10/SA1/H/INGO/5105,12627,19681,18286,20377,70971,31507,32794,10250,10669,85220
19,South Sudan,2,2017,SSD-17/HSS10/SA1/H/NGO/5107,13955,17645,3696,4704,40000,10761,11201,10085,10497,42544
19,South Sudan,2,2017,SSD-17/HSS10/SA1/L/UN/5108,40,40,0,0,80,0,0,0,89,89
19,South Sudan,2,2017,SSD-17/HSS10/SA1/WASH/NGO/5109,1912,2578,2100,2410,9000,2061,2622,2199,2555,9437
19,South Sudan,2,2017,SSD-17/HSS10/SA1/FSL/NGO/5113,1500,1500,3000,3000,9000,2400,3600,4800,7272,18072
19,South Sudan,2,2017,SSD-17/HSS10/SA1/FSL/NGO/5116,4500,6500,500,500,12000,4056,7944,0,0,12000
19,South Sudan,2,2017,SSD-17/HSS10/SA1/H/INGO/5117,4479,6792,1488,1488,14247,4596,7189,1491,1829,15105
19,South Sudan,2,2017,SSD-17/HSS10/SA1/N/INGO/5119,0,7897,8391,8734,25022,0,6117,10604,8267,24988
19,South Sudan,2,2017,SSD-17/HSS10/SA1/N/NGO/5121,3901,4900,8246,9246,26293,3901,4900,8246,9246,26293
19,South Sudan,2,2017,SSD-17/HSS10/SA1/P/INGO/5122,1100,1600,2366,3174,8240,3292,2405,2843,4619,13159
19,South Sudan,2,2017,SSD-17/HSS10/SA1/H/NGO/5125,780,890,1003,1120,3793,678,725,896,937,3236
19,South Sudan,2,2017,SSD-17/HSS10/SA1/WASH/INGO/5132,10000,12000,23500,24500,70000,9980,13313,22795,23133,69221
19,South Sudan,2,2017,SSD-17/HSS10/SA1/P/NGO/5137,65,75,1900,1900,3940,756,1693,2302,2895,7646
19,South Sudan,2,2017,SSD-17/HSS10/SA1/NFI/INGO/5138,9602,11305,19219,19961,60087,15901,18662,15467,17671,67701
19,South Sudan,2,2017,SSD-17/HSS10/SA1/P/INGO/5147,1282,10933,801,2220,15236,226,2957,376,2178,5737
19,South Sudan,2,2017,SSD-17/HSS10/SA1/N/NGO/5155,0,3382,3922,3512,10816,0,3753,3044,2874,9671
19,South Sudan,2,2017,SSD-17/HSS10/SA1/WASH/INGO/5156,6020,8800,6240,11840,32900,6697,9616,6906,12558,35777
19,South Sudan,2,2017,SSD-17/HSS10/SA1/H/NGO/5157,4556,6883,1534,1700,14673,4975,7574,1647,2100,16296
19,South Sudan,2,2017,SSD-17/HSS10/SA1/E/INGO/5158,1591,1855,6950,4416,14812,1767,2000,7749,4303,15819
19,South Sudan,2,2017,SSD-17/HSS10/SA1/FSL/NGO/5164,3200,7800,4000,9000,24000,3500,7500,4500,8500,24000
19,South Sudan,2,2017,SSD-17/HSS10/SA1/N/UN/5173,0,97300,1191,1239,99730,0,106542,1250,1301,109093
19,South Sudan,2,2017,SSD-17/HSS10/SA1/H/INGO/5174,3473,4387,465,493,8818,2790,3845,1384,1407,9426
19,South Sudan,2,2017,SSD-17/HSS10/SA1/N/NGO/5177,600,3000,2000,2000,7600,168,2133,3009,2974,8284
19,South Sudan,2,2017,SSD-17/HSS10/SA1/H/NGO/5180,962,1974,2371,2182,7489,878,1770,2270,1438,6356
19,South Sudan,2,2017,SSD-17/HSS10/SA1/NFI/NGO/5184,1395,1447,1005,1153,5000,832,1213,1940,2830,6815
19,South Sudan,2,2017,SSD-17/HSS10/SA1/WASH/NGO/5185,3121,3860,2015,3004,12000,3400,4000,1900,3700,13000
19,South Sudan,2,2017,SSD-17/HSS10/SA1/H/UN/5190,11533,12494,11081,12004,47112,572,8498,22481,23309,54860
19,South Sudan,2,2017,SSD-17/HSS10/SA1/H/NGO/5191,500,1631,2100,2291,6522,1186,4160,4577,4992,14915
19,South Sudan,2,2017,SSD-17/HSS10/SA1/WASH/UN/5196,5400,6800,6000,6800,25000,6483,8164,7204,7794,29645
19,South Sudan,2,2017,SSD-17/HSS10/SA1/WASH/INGO/5203,1455,1515,2955,3075,9000,1170,1380,2600,2650,7800
19,South Sudan,2,2017,SSD-17/HSS10/SA1/P/NGO/5206,1350,1870,350,450,4020,1560,2430,609,789,5388
19,South Sudan,2,2017,SSD-17/HSS10/SA1/WASH/NGO/5215,7000,9000,6500,7500,30000,8655,11128,8033,9278,37094
19,South Sudan,2,2017,SSD-17/HSS10/SA1/WASH/INGO/5216,7000,9800,4200,7000,28000,11301,11565,3739,4335,30940
19,South Sudan,2,2017,SSD-17/HSS10/SA1/CCCM/INGO/5222,11098,14544,12265,14549,52456,6196,8535,9028,9795,33554
19,South Sudan,2,2017,SSD-17/HSS10/SA1/NFI/INGO/5223,10145,11170,9787,10898,42000,9566,11096,13927,14784,49373
19,South Sudan,2,2017,SSD-17/HSS10/SA1/NFI/NGO/5224,4632,6588,3118,5662,20000,3511,3793,4446,4937,16687
19,South Sudan,2,2017,SSD-17/HSS10/SA1/FSL/INGO/5228,5221,5657,5435,5887,22200,5221,5657,5435,5887,22200
19,South Sudan,2,2017,SSD-17/HSS10/SA1/FSL/NGO/5230,9000,15000,3000,3000,30000,5978,18022,2437,3563,30000
19,South Sudan,2,2017,SSD-17/HSS10/SA1/H/UN/5232,48693,45936,3675,3825,102129,29471,37284,41908,52731,161394
19,South Sudan,2,2017,SSD-17/HSS10/SA1/WASH/INGO/5233,4629,5951,5060,5385,21025,4297,6531,5886,5299,22013
19,South Sudan,2,2017,SSD-17/HSS10/SA1/WASH/INGO/5234,4091,4150,7329,7430,23000,3752,4787,7626,8444,24609
19,South Sudan,2,2017,SSD-17/HSS10/SA1/P/INGO/5235,742,1484,2226,2968,7420,3098,5796,2218,3724,14836
19,South Sudan,2,2017,SSD-17/HSS10/SA1/P/UN/5236,100,250,2300,2750,5400,100,250,18901,11335,30586
19,South Sudan,2,2017,SSD-17/HSS10/SA1/NFI/INGO/5238,14147,13659,10732,10244,48782,16463,18224,19394,22150,76231
19,South Sudan,2,2017,SSD-17/HSS10/SA1/FSL/NGO/5239,5760,8100,1800,2340,18000,5760,8100,1800,2340,18000
19,South Sudan,2,2017,SSD-17/HSS10/SA1/FSL/NGO/5243,3400,8000,3400,3200,18000,3400,8000,3400,3200,18000
19,South Sudan,2,2017,SSD-17/HSS10/SA1/WASH/INGO/5253,3100,3500,2900,3000,12500,3100,3500,2900,3000,12500
19,South Sudan,2,2017,SSD-17/HSS10/SA1/FSL/NGO/5259,1800,2400,240,360,4800,200,320,120,160,800
19,South Sudan,2,2017,SSD-17/HSS10/SA1/NFI/INGO/5260,3700,3700,3800,3800,15000,1057,1256,1983,1419,5715
19,South Sudan,2,2017,SSD-17/HSS10/SA1/H/NGO/5261,9258,5401,8545,13885,37089,8760,5210,8320,13010,35300
19,South Sudan,2,2017,SSD-17/HSS10/SA1/H/NGO/5262,1025,2933,1827,3793,9578,1609,3455,2150,3888,11102
19,South Sudan,2,2017,SSD-17/HSS10/SA1/H/INGO/5263,1324,1493,549,650,4016,416,5644,749,816,7625
19,South Sudan,2,2017,SSD-17/HSS10/SA1/N/INGO/5266,602,7824,3435,3709,15570,1059,7946,2472,2777,14254
19,South Sudan,2,2017,SSD-17/HSS10/SA1/N/INGO/5268,370,6937,8428,8772,24507,136,6827,9270,9210,25443
19,South Sudan,2,2017,SSD-17/HSS10/SA1/N/INGO/5276,1000,5000,9781,10928,26709,942,11469,11064,12728,36203
19,South Sudan,2,2017,SSD-17/HSS10/SA1/N/UN/5283,0,4000,19600,20400,44000,0,6544,7952,8336,22832
19,South Sudan,2,2017,SSD-17/HSS10/SA1/L/UN/5559,240,0,0,0,240,274,0,0,0,274
19,South Sudan,2,2017,SSD-17/HSS10/SA2/NFI/NGO/6438,5200,7800,0,0,13000,5188,5095,0,0,10283
19,South Sudan,2,2017,SSD-17/HSS10/SA2/E/NGO/6439,342,146,7440,4560,12488,342,146,9737,4795,15020
19,South Sudan,2,2017,SSD-17/HSS10/SA2/WASH/NGO/6440,6000,16000,10000,8000,40000,9592,15852,18335,18498,62277
19,South Sudan,2,2017,SSD-17/HSS10/SA2/FSL/NGO/6441,45885,30590,2415,1610,80500,35623,41622,1505,1750,80500
19,South Sudan,2,2017,SSD-17/HSS10/SA2/H/NGO/6442,3450,4600,1610,1840,11500,7700,10265,3593,4110,25668
19,South Sudan,2,2017,SSD-17/HSS10/SA2/WASH/NGO/6444,3200,4500,1253,2169,11122,3390,5200,2000,3610,14200
19,South Sudan,2,2017,SSD-17/HSS10/SA2/WASH/NGO/6445,4995,6623,4877,5605,22100,6370,7693,4411,5368,23842
19,South Sudan,2,2017,SSD-17/HSS10/SA2/NFI/INGO/6446,1542,2571,4242,4498,12853,3676,3962,2511,2721,12870
19,South Sudan,2,2017,SSD-17/HSS10/SA2/H/NGO/6449,12888,50000,5082,4830,72800,10196,27076,5723,4942,47937
19,South Sudan,2,2017,SSD-17/HSS10/SA2/H/INGO/6450,7985,8312,1835,1988,20120,7742,8931,2441,3694,22808
19,South Sudan,2,2017,SSD-17/HSS10/SA2/E/INGO/6451,324,139,6746,3612,10821,220,237,6241,6085,12783
19,South Sudan,2,2017,SSD-17/HSS10/SA2/P/INGO/6452,150,730,210,270,1360,94,77,6,1,178
19,South Sudan,2,2017,SSD-17/HSS10/SA2/FSL/NGO/6454,12600,21000,4200,4200,42000,14052,17118,4512,6318,42000
19,South Sudan,2,2017,SSD-17/HSS10/SA2/H/INGO/6456,4249,4422,1129,1176,10976,4295,4493,2068,2196,13052
19,South Sudan,2,2017,SSD-17/HSS10/SA2/L/UN/6457,240,0,0,0,240,274,0,0,0,274
19,South Sudan,2,2017,SSD-17/HSS10/SA2/N/NGO/6460,600,1500,1980,2020,6100,579,1587,2000,2250,6416
19,South Sudan,2,2017,SSD-17/HSS10/SA2/H/NGO/6461,2284,2781,3046,3427,11538,1470,2390,2712,2921,9493
19,South Sudan,2,2017,SSD-17/HSS10/SA2/WASH/UN/6462,28500,49500,34500,37500,150000,28500,49500,34500,37500,150000
19,South Sudan,2,2017,SSD-17/HSS10/SA2/CCS/UN/6463,41,0,0,0,41,41,0,0,0,41
19,South Sudan,2,2017,SSD-17/HSS10/SA2/WASH/UN/6465,7500,45000,17500,55000,125000,8104,48620,18907,59423,135054
19,South Sudan,2,2017,SSD-17/HSS10/SA2/H/NGO/6467,7000,7500,4000,4500,23000,6243,7242,3814,4214,21513
19,South Sudan,2,2017,SSD-17/HSS10/SA2/WASH/NGO/6468,2100,3400,1500,1663,8663,2973,3555,2649,3106,12283
19,South Sudan,2,2017,SSD-17/HSS10/SA2/NFI/NGO/6470,1986,4636,2649,3974,13245,1002,3526,8575,9660,22763
19,South Sudan,2,2017,SSD-17/HSS10/SA2/H/NGO/6471,3750,5252,2248,3750,15000,3978,5875,4317,4150,18320
19,South Sudan,2,2017,SSD-17/HSS10/SA2/H/NGO/6472,9334,10112,2584,2585,24615,10219,12107,2801,2910,28037
19,South Sudan,2,2017,SSD-17/HSS10/SA2/H/NGO/6474,2000,3200,2000,2800,10000,4527,6526,6377,8899,26329
19,South Sudan,2,2017,SSD-17/HSS10/SA2/N/NGO/6478,24131,26140,5009,6783,62063,19651,22314,3235,4600,49800
19,South Sudan,2,2017,SSD-17/HSS10/SA2/H/INGO/6479,3105,3620,864,900,8489,1160,2007,1067,1390,5624
19,South Sudan,2,2017,SSD-17/HSS10/SA2/WASH/INGO/6480,5500,7700,3300,5500,22000,9478,8325,5637,5833,29273
19,South Sudan,2,2017,SSD-17/HSS10/SA2/H/NGO/6482,1920,2450,1580,1742,7692,1600,2209,425,588,4822
19,South Sudan,2,2017,SSD-17/HSS10/SA2/WASH/NGO/6483,4460,12355,5800,7900,30515,5110,13815,7240,9050,35215
19,South Sudan,2,2017,SSD-17/HSS10/SA2/NFI/NGO/6486,3200,4200,2500,5100,15000,2275,5201,1331,3125,11932
19,South Sudan,2,2017,SSD-17/HSS10/SA2/H/UN/6489,5000,20000,4000,5000,34000,4890,21990,3500,5800,36180
19,South Sudan,2,2017,SSD-17/HSS10/SA2/FSL/NGO/6490,9120,13680,13680,20520,57000,9100,13700,13500,20720,57020
19,South Sudan,2,2017,SSD-17/HSS10/SA2/P/NGO/6491,1000,1500,3000,3000,8500,1199,1901,3960,3012,10072
19,South Sudan,2,2017,SSD-17/HSS10/SA2/P/INGO/6492,628,1257,1884,2513,6282,1716,6404,517,1908,10545
19,South Sudan,2,2017,SSD-17/HSS10/SA2/P/NGO/6493,150,200,1460,1760,3570,63,9,1340,1580,2992
19,South Sudan,2,2017,SSD-17/HSS10/SA2/NFI/NGO/6494,1000,1783,1000,1217,5000,1669,2078,2015,2020,7782
19,South Sudan,2,2017,SSD-17/HSS10/SA2/N/INGO/6495,0,955,1344,1456,3755,0,853,1099,1225,3177
19,South Sudan,2,2017,SSD-17/HSS10/SA2/H/INGO/6499,13884,19130,6963,6963,46940,14178,19587,7087,7142,47994
19,South Sudan,2,2017,SSD-17/HSS10/SA2/FSL/NGO/6500,8035,8555,2136,2274,21000,8035,8555,2136,2274,21000
19,South Sudan,2,2017,SSD-17/HSS10/SA2/N/NGO/6501,308,1191,10122,10122,21743,352,1348,11960,11900,25560
19,South Sudan,2,2017,SSD-17/HSS10/SA2/P/INGO/6502,495,2780,515,1580,5370,1785,6189,988,2040,11002
19,South Sudan,2,2017,SSD-17/HSS10/SA2/WASH/INGO/6503,2550,4650,3800,5500,16500,2888,4332,4324,6487,18031
19,South Sudan,2,2017,SSD-17/HSS10/SA2/NFI/NGO/6504,738,3443,1721,2295,8197,561,6024,3162,3425,13172
19,South Sudan,2,2017,SSD-17/HSS10/SA2/H/NGO/6507,3500,5900,3200,3900,16500,111569,117038,29657,31085,289349
19,South Sudan,2,2017,SSD-17/HSS10/SA2/H/INGO/6508,39357,42637,10462,11334,103790,14969,19645,12432,13516,60562
19,South Sudan,2,2017,SSD-17/HSS10/SA2/N/INGO/6509,300,15155,17277,18717,51449,341,27108,35266,39674,102389
19,South Sudan,2,2017,SSD-17/HSS10/SA2/NFI/INGO/6512,4100,7900,8900,9100,30000,0,0,0,0,0
19,South Sudan,2,2017,SSD-17/HSS10/SA2/WASH/NGO/6513,1250,1875,0,0,3125,1566,1559,0,0,3125
19,South Sudan,2,2017,SSD-17/HSS10/SA2/P/UN/6515,0,5000,0,2000,7000,0,5114,0,1926,7040
19,South Sudan,2,2017,SSD-17/HSS10/SA2/P/NGO/6517,100,140,6085,6085,12410,161,248,6062,6132,12603
19,South Sudan,2,2017,SSD-17/HSS10/SA2/N/NGO/6518,200,2800,4000,4000,11000,252,2404,2714,3196,8566
19,South Sudan,2,2017,SSD-17/HSS10/SA2/WASH/INGO/6519,11760,12740,12240,13260,50000,16923,21409,9142,14716,62190
19,South Sudan,2,2017,SSD-17/HSS10/SA2/H/UN/6521,6000,6000,1500,1500,15000,6000,6000,1500,1500,15000
19,South Sudan,2,2017,SSD-17/HSS10/SA2/L/UN/6525,30,0,0,0,30,23,0,0,0,23
19,South Sudan,2,2017,SSD-17/HSS10/SA2/WASH/INGO/6527,2240,2660,4620,4480,14000,3801,4383,3679,5261,17124
19,South Sudan,2,2017,SSD-17/HSS10/SA2/N/INGO/6534,0,2936,3741,4055,10732,0,2091,14053,11627,27771
19,South Sudan,2,2017,SSD-17/HSS10/SA2/WASH/INGO/6535,4023,5238,4339,4710,18310,3797,5531,5886,5299,20513
19,South Sudan,2,2017,SSD-17/HSS10/SA2/L/UN/6536,40,40,0,0,80,40,40,0,0,80
19,South Sudan,2,2017,SSD-17/HSS10/SA2/P/NGO/6537,167,871,620,912,2570,231,1524,763,954,3472
19,South Sudan,2,2017,SSD-17/HSS10/SA2/NFI/UN/6539,25078,34483,47022,50157,156740,0,0,0,0,0
19,South Sudan,2,2017,SSD-17/HSS10/SA2/N/INGO/6542,0,4203,2374,2571,9148,0,667,406,449,1522
19,South Sudan,2,2017,SSD-17/HSS10/SA2/P/NGO/6544,266,766,5000,4500,10532,579,1365,4606,3580,10130
19,South Sudan,2,2017,SSD-17/HSS10/SA2/WASH/NGO/6545,5000,7000,6000,7000,25000,12423,13621,12647,16444,55135
19,South Sudan,2,2017,SSD-17/HSS10/SA2/P/NGO/6546,550,550,1500,1500,4100,562,676,1748,1889,4875
19,South Sudan,2,2017,SSD-17/HSS10/SA2/FSL/NGO/6547,11400,16700,8400,8500,45000,11400,16700,8400,8500,45000
19,South Sudan,2,2017,SSD-17/HSS10/SA2/P/INGO/6550,1000,1000,5000,5000,12000,456,336,5815,3900,10507
19,South Sudan,2,2017,SSD-17/HSS10/SA2/P/UN/6554,500,1250,2400,2600,6750,2422,2383,7676,6752,19233
19,South Sudan,2,2017,SSD-17/HSS10/SA2/NFI/INGO/6555,11777,11371,8935,8528,40611,14268,16231,12811,15346,58656
19,South Sudan,2,2017,SSD-17/HSS10/SA2/H/INGO/6556,17142,17842,19331,20120,74435,3770,4652,1873,2349,12644
19,South Sudan,2,2017,SSD-17/HSS10/SA2/N/INGO/6557,400,5533,6439,6701,19073,267,6905,8892,9750,25814
19,South Sudan,2,2017,SSD-17/HSS10/SA2/FSL/NGO/6559,4000,4000,8000,8000,24000,2620,3210,8200,9970,24000
19,South Sudan,2,2017,SSD-17/HSS10/SA2/E/NGO/6567,320,160,5600,3200,9280,320,160,8015,5153,13648
19,South Sudan,2,2017,SSD-17/HSS10/SA2/NFI/INGO/6568,10433,11482,10075,11210,43200,12773,18420,17479,19057,67729
19,South Sudan,2,2017,SSD-17/HSS10/SA2/E/INGO/6571,390,400,10901,6621,18312,390,450,9906,6976,17722
19,South Sudan,2,2017,SSD-17/HSS10/SA2/E/NGO/6572,500,500,4800,3200,9000,419,209,5235,4345,10208
19,South Sudan,2,2017,SSD-17/HSS10/SA2/P/NGO/6573,1000,2500,1000,1500,6000,1100,3000,1000,1800,6900
19,South Sudan,2,2017,SSD-17/HSS10/SA2/P/INGO/6574,70,70,1500,1500,3140,205,568,2383,3434,6590
19,South Sudan,2,2017,SSD-17/HSS10/SA2/E/INGO/6577,206,101,4222,3232,7761,197,99,3803,3134,7233
19,South Sudan,2,2017,SSD-17/HSS10/SA2/H/UN/6580,10071,12377,10759,11586,44793,32928,49386,102053,144835,329202
19,South Sudan,2,2017,SSD-17/HSS10/SA2/FSL/NGO/6581,3690,3852,5148,5310,18000,3690,3852,5148,5310,18000
19,South Sudan,2,2017,SSD-17/HSS10/SA2/P/NGO/6584,1100,1500,700,700,4000,1290,1650,760,815,4515
19,South Sudan,2,2017,SSD-17/HSS10/SA2/N/UN/6587,0,7672,13123,13659,34454,0,46302,28943,32077,107322
19,South Sudan,2,2017,SSD-17/HSS10/SA2/FSL/UN/6590,53160,79740,53160,79740,265800,0,0,0,0,0
19,South Sudan,2,2017,SSD-17/HSS10/SA2/WASH/NGO/6593,2340,3760,1507,1046,8653,2640,4060,1800,1280,9780
19,South Sudan,2,2017,SSD-17/HSS10/SA2/N/NGO/6596,2927,6341,3902,4228,17398,1770,5469,2861,3600,13700
19,South Sudan,2,2017,SSD-17/HSS10/SA2/P/INGO/6598,650,2600,1300,1950,6500,3366,5061,2554,3358,14339
19,South Sudan,2,2017,SSD-17/HSS10/SA2/P/INGO/6604,1591,1781,2138,1908,7418,1377,1735,1616,1605,6333
19,South Sudan,2,2017,SSD-17/HSS10/SA2/CCCM/INGO/6880,2600,3000,3900,4500,14000,2311,2028,2186,2299,8824
19,South Sudan,1,2017,SSD-17/HSS10/RA1/H/UN/7621,0,17748,97685,101672,217105,0,12894,150429,175324,338647
19,South Sudan,1,2017,SSD-17/HSS10/RA1/H/UN/7624,9000,60304,1000,5000,75304,11044,60741,789,6311,78885
19,South Sudan,1,2017,SSD-17/HSS10/RA1/WASH/UN/7626,18543,21768,22665,26607,89583,19060,22374,23296,27349,92079
19,South Sudan,1,2017,SSD-17/HSS10/RA1/P/UN/7629,0,11000,0,4000,15000,0,10143,0,4857,15000
19,South Sudan,1,2017,SSD-17/HSS10/RA1/WASH/UN/7630,20700,25200,21600,22500,90000,20500,25500,22000,24000,92000
19,South Sudan,1,2017,SSD-17/HSS10/RA1/E/UN/7638,560,240,18000,12000,30800,402,88,16652,9420,26562
19,South Sudan,1,2017,SSD-17/HSS10/RA1/FSL/UN/7639,27906,41859,27906,41859,139530,0,0,0,0,0
19,South Sudan,1,2017,SSD-17/HSS10/RA1/P/UN/7640,0,0,39215,32085,71300,0,0,23722,19831,43553
19,South Sudan,1,2017,SSD-17/HSS10/RA1/NFI/UN/7641,21321,25016,21911,24312,92560,0,0,0,0,0
19,South Sudan,1,2017,SSD-17/HSS10/RA1/N/UN/7642,0,0,9179,9554,18733,0,0,3845,4002,7847
19,South Sudan,2,2018,SSD-18/HSS10/SA1/E/NGO/7880,173,214,6259,3841,10487,572,399,7603,4356,12930
19,South Sudan,2,2018,SSD-18/HSS10/SA1/H/NGO/7883,3429,5000,6000,7000,21429,4723,6888,10266,9081,30958
19,South Sudan,2,2018,SSD-18/HSS10/SA1/CCCM/UN/7890,5254,6760,6265,6138,24417,5254,6760,6265,6138,24417
19,South Sudan,2,2018,SSD-18/HSS10/SA1/WASH/NGO/7892,2500,4000,3500,5000,15000,2557,3992,3493,4958,15000
19,South Sudan,2,2018,SSD-18/HSS10/SA1/L/UN/7904,271,0,0,0,271,287,0,0,0,287
19,South Sudan,2,2018,SSD-18/HSS10/SA1/N/INGO/7917,0,4339,5834,6073,16246,0,7110,5969,7365,20444
19,South Sudan,2,2018,SSD-18/HSS10/SA1/FSL/NGO/7929,12780,21300,4260,4260,42600,9120,29028,762,1890,40800
19,South Sudan,2,2018,SSD-18/HSS10/SA1/N/NGO/7944,342,2038,1892,1892,6164,277,2329,2608,2932,8146
19,South Sudan,2,2018,SSD-18/HSS10/SA1/FSL/NGO/7947,3500,11300,3000,3200,21000,3500,11300,3000,3200,21000
19,South Sudan,2,2018,SSD-18/HSS10/SA1/NFI/INGO/7953,2856,2744,4284,4116,14000,3663,3813,5495,5720,18691
19,South Sudan,2,2018,SSD-18/HSS10/SA1/FSL/INGO/7965,3000,3000,7500,7500,21000,5538,12384,1074,2004,21000
19,South Sudan,2,2018,SSD-18/HSS10/SA1/N/INGO/7978,1018,9861,13746,14308,38933,34,23136,22378,25707,71255
19,South Sudan,2,2018,SSD-18/HSS10/SA1/H/NGO/7979,6200,7500,6000,6014,25714,6422,8332,4355,5127,24236
19,South Sudan,2,2018,SSD-18/HSS10/SA1/H/NGO/7985,5530,5756,1470,1530,14286,19567,26555,5956,8193,60271
19,South Sudan,2,2018,SSD-18/HSS10/SA1/NFI/NGO/7998,2625,3209,3209,3922,12965,656,985,353,530,2524
19,South Sudan,2,2018,SSD-18/HSS10/SA1/E/NGO/8036,75,55,2860,2140,5130,93,43,1703,1446,3285
19,South Sudan,2,2018,SSD-18/HSS10/SA1/FSL/NGO/8046,6528,9792,9792,14688,40800,7028,9802,9788,14284,40902
19,South Sudan,2,2018,SSD-18/HSS10/SA1/FSL/NGO/8069,1268,2012,135,85,3500,1268,2012,135,85,3500
19,South Sudan,2,2018,SSD-18/HSS10/SA1/P/NGO/8072,410,750,415,645,2220,316,578,235,412,1541
19,South Sudan,2,2018,SSD-18/HSS10/SA1/N/INGO/8074,400,4998,3934,4094,13426,16,3197,2358,2177,7748
19,South Sudan,2,2018,SSD-18/HSS10/SA1/FSL/NGO/8089,4000,4000,9500,9500,27000,4000,4000,9500,9500,27000
19,South Sudan,2,2018,SSD-18/HSS10/SA1/P/NGO/8096,800,800,1200,1200,4000,519,815,1020,927,3281
19,South Sudan,2,2018,SSD-18/HSS10/SA1/H/UN/8121,450,2450,11871,13800,28571,5503,7807,11158,10051,34519
19,South Sudan,2,2018,SSD-18/HSS10/SA1/E/INGO/8126,205,75,3323,2845,6448,0,0,6448,3319,9767
19,South Sudan,2,2018,SSD-18/HSS10/SA1/E/NGO/8144,240,120,4200,2400,6960,240,120,4850,2559,7769
19,South Sudan,2,2018,SSD-18/HSS10/SA1/N/UN/8176,3000,29000,964,1004,33968,1040,13686,743,772,16241
19,South Sudan,2,2018,SSD-18/HSS10/SA1/FSL/INGO/8190,9384,10170,3126,3390,26070,7938,18036,18,108,26100
19,South Sudan,2,2018,SSD-18/HSS10/SA1/E/INGO/8191,1580,1420,500,500,4000,3802,1797,620,440,6659
19,South Sudan,2,2018,SSD-18/HSS10/SA1/H/INGO/8205,16286,17571,4286,4714,42857,27969,31804,13570,13064,86407
19,South Sudan,2,2018,SSD-18/HSS10/SA1/NFI/INGO/8220,1948,2030,2030,2110,8118,1704,1717,721,1045,5187
19,South Sudan,2,2018,SSD-18/HSS10/SA1/WASH/NGO/8238,2100,5200,2500,3700,13500,2320,3835,4731,5062,15948
19,South Sudan,2,2018,SSD-18/HSS10/SA1/FSL/NGO/8252,6480,6804,9396,9720,32400,6480,6804,9396,9720,32400
19,South Sudan,2,2018,SSD-18/HSS10/SA1/FSL/INGO/8255,21840,40560,5460,10140,78000,35100,42900,0,0,78000
19,South Sudan,2,2018,SSD-18/HSS10/SA1/FSL/NGO/8259,6000,9000,3000,3000,21000,6000,9000,3000,3000,21000
19,South Sudan,2,2018,SSD-18/HSS10/SA1/P/NGO/8306,500,2500,500,1500,5000,200,1800,250,800,3050
19,South Sudan,2,2018,SSD-18/HSS10/SA1/N/UN/8314,0,4987,5443,5897,16327,0,7453,4106,4448,16007
15,Sudan,2,2013,SUD-13/S1/N/NGO/5,12500,12500,12500,12500,50000,0,0,0,0,0
15,Sudan,2,2013,SUD-13/S1/MA/NGO/6,13000,12000,11000,11000,47000,12419,11337,11353,12483,47592
15,Sudan,2,2013,SUD-13/S1/MA/NGO/7,4000,5000,3000,3000,15000,3952,6202,4738,5401,20293
15,Sudan,2,2013,SUD-13/S1/WASH/UN/11,40200,41800,9000,9000,100000,40200,41800,9000,9000,100000
15,Sudan,2,2013,SUD-13/S1/WASH/UN/12,4131,6356,4902,4901,20290,16963,25848,15040,22923,80774
15,Sudan,2,2013,SUD-13/S1/WASH/NGO/13,14123,14700,3267,3266,35356,14293,14795,4272,3306,36666
15,Sudan,2,2013,SUD-13/S1/WASH/NGO/14,2970,4725,2902,2903,13500,3303,5255,3228,3229,15015
15,Sudan,2,2013,SUD-13/S1/WASH/NGO/15,13367,15918,11982,11983,53250,13367,15918,11982,11983,53250
15,Sudan,2,2013,SUD-13/S1/WASH/NGO/16,21400,20000,3520,3520,48440,21840,20160,10920,10080,63000
15,Sudan,2,2013,SUD-13/S1/WASH/NGO/17,10263,14988,3000,3169,31420,10263,14988,2776,3393,31420
15,Sudan,2,2013,SUD-13/S1/WASH/NGO/18,5000,5000,13000,12000,35000,7333,6633,2768,3740,20474
15,Sudan,2,2013,SUD-13/S1/WASH/NGO/19,22793,24263,13235,13234,73525,22793,24263,13235,13234,73525
15,Sudan,2,2013,SUD-13/S1/WASH/NGO/20,7000,11000,2000,3000,23000,0,0,0,0,0
15,Sudan,2,2013,SUD-13/S1/WASH/NGO/21,30545,50460,24000,24000,129005,30545,50460,24000,24000,129005
15,Sudan,2,2013,SUD-13/S1/WASH/NGO/22,25202,36485,6317,6318,74322,24255,34367,7553,8273,74448
15,Sudan,2,2013,SUD-13/S1/WASH/NGO/23,10000,20000,5000,5000,40000,27600,36400,7000,8000,79000
15,Sudan,2,2013,SUD-13/S1/WASH/NGO/24,36056,37527,13000,12854,99437,34337,30045,29082,36000,129464
15,Sudan,2,2013,SUD-13/S1/E/NGO/25,156,154,2281,2000,4591,162,158,2398,2103,4821
15,Sudan,2,2013,SUD-13/S1/E/NGO/26,450,450,16144,24216,41260,480,364,43221,44986,89051
15,Sudan,2,2013,SUD-13/S1/E/NGO/27,82,76,1900,1900,3958,74,167,1267,1841,3349
15,Sudan,2,2013,SUD-13/S1/E/NGO/28,18,24,486,913,1441,38,18,411,1008,1475
15,Sudan,2,2013,SUD-13/S1/E/NGO/29,50,75,5280,3520,8925,54,71,4222,3478,7825
15,Sudan,2,2013,SUD-13/S1/E/UN/31,495,550,8000,8000,17045,796,734,7000,9000,17530
15,Sudan,2,2013,SUD-13/S1/E/NGO/32,236,249,7133,5296,12914,241,254,7813,5426,13734
15,Sudan,2,2013,SUD-13/S1/E/NGO/33,1392,1928,6720,4480,14520,0,0,0,0,0
15,Sudan,2,2013,SUD-13/S1/E/NGO/34,490,1934,11590,11590,25604,766,2343,14382,20888,38379
15,Sudan,2,2013,SUD-13/S1/FSL/NGO/36,29500,43500,21000,21000,115000,29500,43500,20580,21420,115000
15,Sudan,2,2013,SUD-13/S1/FSL/NGO/37,4574,4760,933,934,11201,12327,13877,41631,41631,109466
15,Sudan,2,2013,SUD-13/S1/FSL/NGO/38,9638,14554,1100,1208,26500,9653,14554,1100,1208,26515
15,Sudan,2,2013,SUD-13/S1/FSL/UN/39,241122,247123,26477,26478,541200,212678,238494,51314,51314,553800
15,Sudan,2,2013,SUD-13/S1/FSL/UN/40,110179,131669,20331,20331,282510,205540,247704,36892,36892,527028
15,Sudan,2,2013,SUD-13/S1/FSL/NGO/41,900,1325,2362,2363,6950,523,1762,4979,4979,12243
15,Sudan,2,2013,SUD-13/S1/FSL/NGO/42,3059,9176,7647,7648,27530,4805,14416,12014,12014,43249
15,Sudan,2,2013,SUD-13/S1/FSL/NGO/44,9264,15440,6948,6948,38600,9542,15903,7148,7165,39758
15,Sudan,2,2013,SUD-13/S1/FSL/NGO/45,1956,2119,2038,2038,8151,2428,2744,2119,2341,9632
15,Sudan,2,2013,SUD-13/S1/FSL/NGO/46,2340,2535,2438,2438,9751,2267,2526,4621,5205,14619
15,Sudan,2,2013,SUD-13/S1/FSL/NGO/47,26000,26000,5000,5000,62000,26000,26000,5000,5000,62000
15,Sudan,2,2013,SUD-13/S1/FSL/NGO/48,2176,4548,100,100,6924,2490,4554,100,100,7244
15,Sudan,2,2013,SUD-13/S1/FSL/NGO/49,23000,14000,4000,4000,45000,11883,12400,11088,12309,47680
15,Sudan,2,2013,SUD-13/S1/FSL/UN/50,98163,98163,50570,50570,297466,75584,75584,38938,38938,229044
15,Sudan,2,2013,SUD-13/S1/FSL/NGO/51,2900,16380,6000,6000,31280,2900,16380,6000,6000,31280
15,Sudan,2,2013,SUD-13/S1/GEIR/NGO/52,10975,14487,9219,9219,43900,90,508,65,367,1030
15,Sudan,2,2013,SUD-13/S1/GEIR/NGO/53,287,288,1437,1438,3450,631,631,1581,1581,4424
15,Sudan,2,2013,SUD-13/S1/GEIR/NGO/54,3500,7500,900,900,12800,2800,6101,700,1400,11001
15,Sudan,2,2013,SUD-13/S1/GEIR/UN/55,4496,6826,1600,1704,14626,4496,6826,1304,2000,14626
15,Sudan,2,2013,SUD-13/S1/GEIR/NGO/56,3000,8000,2000,2000,15000,3000,8000,2000,2000,15000
15,Sudan,2,2013,SUD-13/S1/GEIR/NGO/57,3505,6805,0,0,10310,6720,7280,0,0,14000
15,Sudan,2,2013,SUD-13/S1/GEIR/NGO/59,3000,6000,0,0,9000,4140,7210,0,0,11350
15,Sudan,2,2013,SUD-13/S1/L/UN/60,191250,191250,191250,191250,765000,112500,112500,112500,112500,450000
15,Sudan,2,2013,SUD-13/S1/L/UN/61,0,0,0,0,0,1,1,1,1,4
15,Sudan,2,2013,SUD-13/S1/RMS/NGO/62,200,300,84,71,655,0,0,0,0,0
15,Sudan,2,2013,SUD-13/S1/RMS/UN/63,12358,11341,3150,3151,30000,2628,2156,500,500,5784
15,Sudan,2,2013,SUD-13/S1/RMS/NGO/64,70,110,2500,2210,4890,0,0,0,0,0
15,Sudan,2,2013,SUD-13/S1/RMS/UN/65,17560,16577,2334,2334,38805,17560,16577,2334,2334,38805
15,Sudan,2,2013,SUD-13/S1/RMS/UN/66,62985,60515,10498,10497,144495,4797,7675,2878,3837,19187
15,Sudan,2,2013,SUD-13/S1/RMS/NGO/67,800,1000,600,600,3000,669,768,1557,1736,4730
15,Sudan,2,2013,SUD-13/S1/RMS/NGO/68,1454,1426,560,560,4000,1454,1426,2049,2096,7025
15,Sudan,2,2013,SUD-13/S1/P/NGO/69,25000,35000,20000,20000,100000,22400,37000,18200,21700,99300
15,Sudan,2,2013,SUD-13/S1/P/NGO/70,2000,3000,1000,1000,7000,0,0,0,0,0
15,Sudan,2,2013,SUD-13/S1/P/NGO/71,3910,6170,25,25,10130,3411,7465,33,22,10931
15,Sudan,2,2013,SUD-13/S1/P/NGO/72,689,1379,900,900,3868,689,1379,900,900,3868
15,Sudan,2,2013,SUD-13/S1/P/NGO/73,5000,6000,10500,10500,32000,0,0,0,0,0
15,Sudan,2,2013,SUD-13/S1/P/NGO/74,6150,8600,10500,10500,35750,3728,6455,8372,8408,26963
15,Sudan,2,2013,SUD-13/S1/P/NGO/75,370,829,890,890,2979,180,385,480,480,1525
15,Sudan,2,2013,SUD-13/S1/P/NGO/76,440,3350,4863,9726,18379,440,3350,4863,9726,18379
15,Sudan,2,2013,SUD-13/S1/P/NGO/77,350,7200,3920,5100,16570,399,7300,4112,5434,17245
15,Sudan,2,2013,SUD-13/S1/P/UN/78,133203,307392,99902,99902,640399,8468,9128,4849,3793,26238
15,Sudan,2,2013,SUD-13/S1/NFI/NGO/79,4560,4560,1140,1140,11400,4849,4849,1140,1140,11978
15,Sudan,2,2013,SUD-13/S1/NFI/NGO/80,4000,8000,1500,1500,15000,4729,9456,1446,2100,17731
15,Sudan,2,2013,SUD-13/S1/NFI/NGO/83,1920,1920,480,480,4800,1920,1920,480,480,4800
15,Sudan,2,2013,SUD-13/S1/NFI/NGO/84,10200,15300,12750,12750,51000,4104,8157,3833,4235,20329
15,Sudan,2,2013,SUD-13/S1/NFI/NGO/85,3000,6000,4500,4500,18000,3032,5885,4954,3964,17835
15,Sudan,2,2013,SUD-13/S1/NFI/NGO/86,6600,9000,2700,2700,21000,6600,9000,2700,2700,21000
15,Sudan,2,2013,SUD-13/S1/NFI/NGO/87,2160,1800,1500,1470,6930,2087,1785,1320,1250,6442
15,Sudan,2,2013,SUD-13/S1/NFI/NGO/88,2289,3414,704,704,7111,638,2260,874,874,4646
15,Sudan,2,2013,SUD-13/S1/NFI/NGO/89,12915,14760,4612,4613,36900,0,0,0,0,0
15,Sudan,2,2013,SUD-13/S1/NFI/NGO/90,5184,7776,4300,4340,21600,2824,4236,2353,2353,11766
15,Sudan,2,2013,SUD-13/S1/NFI/NGO/91,13580,27080,6750,6750,54160,3375,3375,1125,1125,9000
15,Sudan,2,2013,SUD-13/S1/NFI/NGO/92,39030,62448,4554,4555,110587,0,0,0,0,0
15,Sudan,2,2013,SUD-13/S1/NFI/NGO/96,13000,18000,11500,11500,54000,0,0,0,0,0
15,Sudan,2,2013,SUD-13/S1/CCS/NGO/97,295,0,0,0,295,248,139,0,0,387
15,Sudan,2,2013,SUD-13/S1/CCS/NGO/98,38150,43600,13625,13625,109000,43045,49194,13836,16911,122986
15,Sudan,2,2013,SUD-13/S1/CCS/NGO/99,200,300,0,0,500,220,619,0,0,839
15,Sudan,2,2013,SUD-13/S1/CCS/NGO/100,267,133,0,0,400,170,139,0,0,309
15,Sudan,2,2013,SUD-13/S1/N/NGO/101,973,1257,2550,2549,7329,426,2303,1416,1381,5526
15,Sudan,2,2013,SUD-13/S1/N/NGO/102,2797,2813,11591,11592,28793,1770,2400,8706,9288,22164
15,Sudan,2,2013,SUD-13/S1/N/NGO/103,21117,61041,4022,4021,90201,5276,48083,8279,8656,70294
15,Sudan,2,2013,SUD-13/S1/N/NGO/104,558,4182,2444,2444,9628,4494,42147,6160,6412,59213
15,Sudan,2,2013,SUD-13/S1/N/NGO/105,67,4927,6983,5000,16977,194,10052,2363,2121,14730
15,Sudan,2,2013,SUD-13/S1/N/NGO/106,0,40000,16320,15680,72000,0,40000,16880,25072,81952
15,Sudan,2,2013,SUD-13/S1/N/NGO/107,4746,39091,18692,18693,81222,6460,68437,9474,11661,96032
15,Sudan,2,2013,SUD-13/S1/N/NGO/108,12500,25239,23000,23157,83896,17998,107727,69742,75996,271463
15,Sudan,2,2013,SUD-13/S1/N/UN/111,2000,2000,1100,1100,6200,2000,2000,2200,2200,8400
15,Sudan,2,2013,SUD-13/S1/N/NGO/112,500,4780,6250,6250,17780,509,11096,5861,9876,27342
15,Sudan,2,2013,SUD-13/S1/N/NGO/113,0,1764,10869,10869,23502,0,1347,10179,12539,24065
15,Sudan,2,2013,SUD-13/S1/H/NGO/114,150818,72509,24653,24653,272633,105430,113897,25619,24378,269324
15,Sudan,2,2013,SUD-13/S1/H/NGO/115,128193,133425,28431,28432,318481,105124,109415,21092,22849,258480
15,Sudan,2,2013,SUD-13/S1/H/NGO/116,9468,10520,2366,2367,24721,9468,10520,2366,2367,24721
15,Sudan,2,2013,SUD-13/S1/H/NGO/117,37034,38545,8295,8295,92169,40917,60523,24346,26374,152160
15,Sudan,2,2013,SUD-13/S1/H/NGO/118,175085,174876,95889,92285,538135,95675,107120,96969,94908,394672
15,Sudan,2,2013,SUD-13/S1/H/NGO/119,40000,30000,5000,5000,80000,20979,19658,4048,5120,49805
15,Sudan,2,2013,SUD-13/S1/H/NGO/120,149970,132992,25368,20755,329085,68539,125114,40024,40337,274014
15,Sudan,2,2013,SUD-13/S1/H/UN/121,563424,783535,151421,151421,1649801,28000,157000,4000,6000,195000
15,Sudan,2,2013,SUD-13/S1/H/UN/122,450000,240000,80000,80000,850000,230400,249600,156800,163200,800000
15,Sudan,2,2013,SUD-13/S1/H/NGO/123,60627,63102,12671,12671,149071,35929,87817,45926,49391,219063
15,Sudan,2,2013,SUD-13/S1/H/NGO/124,63712,31132,6878,6878,108600,54340,41630,7350,6780,110100
15,Sudan,2,2013,SUD-13/S1/H/NGO/125,8716,19206,10000,10819,48741,7067,25468,17211,14395,64141
15,Sudan,2,2013,SUD-13/S1/H/NGO/127,16757,16165,3372,3372,39666,6553,13559,9257,8422,37791
15,Sudan,2,2013,SUD-13/S1/RER/NGO/129,3000,9000,7500,7500,27000,3000,9000,7500,7500,27000
15,Sudan,2,2013,SUD-13/S1/RER/UN/130,0,65428,6621,6621,78670,0,56786,3463,3463,63712
15,Sudan,2,2013,SUD-13/S1/RER/NGO/131,1052,1346,562,563,3523,1052,1346,562,563,3523
15,Sudan,2,2013,SUD-13/S1/RER/UN/132,41500,41500,8500,8500,100000,28323,26939,40302,43050,138614
15,Sudan,2,2013,SUD-13/S1/WASH/NGO/133,54018,56708,28783,28782,168291,60299,60824,31914,31885,184922
15,Sudan,2,2013,SUD-13/S1/CCS/UN/134,205200,174000,60000,60000,499200,69285,170871,177984,186331,604471
15,Sudan,2,2013,SUD-13/S1/CCS/UN/135,98024,100865,75555,75556,350000,58417,70325,105185,117645,351572
15,Sudan,2,2013,SUD-13/S1/CCS/UN/136,230,70,0,0,300,100,30,0,0,130
15,Sudan,2,2013,SUD-13/S1/H/NGO/138,33138,15062,6025,6025,60250,0,15062,67880,6266,89208
15,Sudan,2,2013,SUD-13/S1/NFI/NGO/149,11500,32500,750,750,45500,12820,29230,1000,2000,45050
15,Sudan,1,2013,SUD-13/ER/N/UN/164,0,0,0,0,0,0,0,0,0,0
15,Sudan,1,2013,SUD-13/ER/P/UN/166,0,0,0,0,0,0,0,0,0,0
15,Sudan,2,2014,SUD-14/S1/H/UN/242,183260,190740,45815,47685,467500,181248,188646,45312,47162,462368
15,Sudan,2,2014,SUD-14/S1/P/UN/254,1584,1296,1716,1404,6000,0,0,0,0,0
15,Sudan,2,2014,SUD-14/S1/WASH/NGO/273,13224,15660,2436,3480,34800,14600,16000,3436,5200,39236
15,Sudan,2,2014,SUD-14/S1/NFI/NGO/276,2800,3200,3350,3225,12575,2600,3400,3570,3005,12575
15,Sudan,2,2014,SUD-14/S1/NFI/NGO/314,3500,7500,3500,4000,18500,3070,7500,4052,6214,20836
15,Sudan,2,2014,SUD-14/S1/H/NGO/326,58344,53856,30056,27744,170000,56477,53001,29230,27190,165898
15,Sudan,2,2014,SUD-14/S1/NFI/NGO/327,7510,9689,7159,6847,31205,4872,6348,4653,4502,20375
15,Sudan,2,2014,SUD-14/S1/NFI/NGO/330,7670,8975,1655,2000,20300,5467,9468,8935,6000,29870
15,Sudan,2,2014,SUD-14/S1/N/NGO/353,28372,32241,33531,34821,128965,19646,40918,32733,35309,128606
15,Sudan,2,2014,SUD-14/S1/H/NGO/356,6285,15320,9820,7857,39282,18850,34453,19415,16161,88879
15,Sudan,2,2014,SUD-14/S1/P/UN/381,4432,17727,4432,4432,31023,3714,17300,0,0,21014
15,Sudan,2,2014,SUD-14/S1/E/NGO/384,300,185,5500,5500,11485,160,315,6248,6444,13167
15,Sudan,2,2014,SUD-14/S1/WASH/NGO/389,6123,7908,5868,5612,25511,6123,7908,5868,5612,25511
15,Sudan,2,2014,SUD-14/S1/E/NGO/390,67,58,1129,2691,3945,57,53,1406,2173,3689
15,Sudan,2,2014,SUD-14/S1/NFI/NGO/394,9998,13336,1363,2353,27050,6000,10000,4000,4325,24325
15,Sudan,2,2014,SUD-14/S1/N/NGO/397,10834,11286,12720,13289,48129,12331,14890,11718,11923,50862
15,Sudan,2,2014,SUD-14/S1/P/NGO/405,5000,6000,15000,16000,42000,4282,5626,6726,6964,23598
15,Sudan,2,2014,SUD-14/S1/WASH/UN/413,22295,23205,34125,34125,113750,20826,23737,20137,28738,93438
15,Sudan,2,2014,SUD-14/S1/P/NGO/425,3024,3456,16,17,6513,2442,5369,25,19,7855
15,Sudan,2,2014,SUD-14/S1/N/NGO/433,459,581,2568,2568,6176,466,570,1466,1692,4194
15,Sudan,2,2014,SUD-14/S1/P/NGO/451,4150,4160,3524,3526,15360,4775,5010,3856,3918,17559
15,Sudan,2,2014,SUD-14/S1/E/NGO/461,190,190,4061,4261,8702,172,239,4650,4515,9576
15,Sudan,2,2014,SUD-14/S1/CCS/NGO/462,90,60,0,0,150,111,65,0,0,176
15,Sudan,2,2014,SUD-14/S1/NFI/NGO/469,893,976,485,446,2800,1165,1275,619,583,3642
15,Sudan,2,2014,SUD-14/S1/L/UN/472,33000,34000,34000,34000,135000,33000,34000,34000,34000,135000
15,Sudan,2,2014,SUD-14/S1/E/NGO/477,132,159,4425,5249,9965,168,117,5219,4782,10286
15,Sudan,2,2014,SUD-14/S1/FSL/NGO/480,2694,3430,2608,3580,12312,6826,8692,6610,9072,31200
15,Sudan,2,2014,SUD-14/S1/WASH/NGO/483,69000,90000,61000,60000,280000,65550,85500,5750,57000,213800
15,Sudan,2,2014,SUD-14/S1/N/NGO/492,2735,20398,12012,12503,47648,5206,25423,7435,8445,46509
15,Sudan,2,2014,SUD-14/S1/N/NGO/519,7079,11250,10204,12092,40625,8638,21610,16924,29043,76215
15,Sudan,2,2014,SUD-14/S1/N/NGO/524,4508,4692,5292,5508,20000,5718,6140,3248,4872,19978
15,Sudan,2,2014,SUD-14/S1/RRR/NGO/525,35234,47285,8679,12654,103852,20100,26300,3562,5682,55644
15,Sudan,2,2014,SUD-14/S1/NFI/NGO/527,2257,3683,2732,3208,11880,988,1612,1196,1404,5200
15,Sudan,2,2014,SUD-14/S1/H/NGO/536,99490,103552,66327,69034,338403,111525,65619,65815,66200,309159
15,Sudan,2,2014,SUD-14/S1/P/NGO/552,12042,14022,9500,9500,45064,12217,13824,9816,9552,45409
15,Sudan,2,2014,SUD-14/S1/FSL/NGO/566,1596,3192,3990,3990,12768,1596,3192,3990,3990,12768
15,Sudan,2,2014,SUD-14/S1/E/NGO/570,350,350,7200,7800,15700,350,350,7200,7800,15700
15,Sudan,2,2014,SUD-14/S1/P/NGO/573,1705,7485,4187,7129,20506,1503,8244,3200,4376,17323
15,Sudan,2,2014,SUD-14/S1/H/NGO/577,65000,172775,56196,62129,356100,37787,66919,26353,32435,163494
15,Sudan,2,2014,SUD-14/S1/H/NGO/582,15400,16000,7000,7000,45400,16320,17589,7741,8012,49662
15,Sudan,2,2014,SUD-14/S1/WASH/NGO/585,17796,21665,8977,11651,60089,17586,20395,7808,8428,54217
15,Sudan,2,2014,SUD-14/S1/E/NGO/588,310,310,1675,2250,4545,142,175,3814,3727,7858
15,Sudan,2,2014,SUD-14/S1/H/UN/603,105000,120000,67500,82500,375000,93240,106560,59940,73260,333000
15,Sudan,2,2014,SUD-14/S1/FSL/NGO/607,5025,6030,10050,12395,33500,5025,6030,10050,12395,33500
15,Sudan,2,2014,SUD-14/S1/FSL/NGO/609,7920,7920,4580,4580,25000,8691,8664,4564,4564,26483
15,Sudan,2,2014,SUD-14/S1/FSL/NGO/614,1837,1913,1225,1275,6250,2170,2330,780,970,6250
15,Sudan,2,2014,SUD-14/S1/WASH/NGO/618,12690,13208,2880,2998,31776,12690,13208,2880,2998,31776
15,Sudan,2,2014,SUD-14/S1/FSL/NGO/620,1384,2076,5536,8304,17300,1246,1915,4089,7389,14639
15,Sudan,2,2014,SUD-14/S1/FSL/NGO/631,5000,5230,7833,8087,26150,3260,3711,6285,6755,20011
15,Sudan,2,2014,SUD-14/S1/E/NGO/635,100,200,981,939,2220,221,243,911,647,2022
15,Sudan,2,2014,SUD-14/S1/P/NGO/655,1441,2839,1890,1890,8060,746,2420,500,400,4066
15,Sudan,2,2014,SUD-14/S1/H/NGO/661,25628,28766,4357,4535,63286,20346,66812,19305,20804,127267
15,Sudan,2,2014,SUD-14/S1/RRR/UN/662,14175,17325,6210,7290,45000,14175,17325,6210,7290,45000
15,Sudan,2,2014,SUD-14/S1/P/NGO/669,4256,3256,4250,3250,15012,3744,3866,4335,3848,15793
15,Sudan,2,2014,SUD-14/S1/FSL/NGO/673,9360,9840,2640,2160,24000,15147,13203,1430,1180,30960
15,Sudan,2,2014,SUD-14/S1/N/NGO/675,2000,35775,14516,14024,66315,2349,29316,15891,21695,69251
15,Sudan,2,2014,SUD-14/S1/NFI/NGO/683,7000,18000,3000,5000,33000,13565,14696,2778,3011,34050
15,Sudan,2,2014,SUD-14/S1/RMS/UN/689,9000,4500,1000,500,15000,0,0,0,0,0
15,Sudan,2,2014,SUD-14/S1/FSL/NGO/695,7885,8875,3000,3000,22760,5417,8051,1575,1575,16618
15,Sudan,2,2014,SUD-14/S1/NFI/NGO/697,10000,12000,3500,4500,30000,800,1000,100,150,2050
15,Sudan,2,2014,SUD-14/S1/E/UN/698,255,295,10000,10000,20550,83,28,9753,10998,20862
15,Sudan,2,2014,SUD-14/S1/E/NGO/703,800,1000,2760,3000,7560,800,1000,2760,3000,7560
15,Sudan,2,2014,SUD-14/S1/NFI/NGO/704,12625,17675,9090,11110,50500,575,625,282,318,1800
15,Sudan,2,2014,SUD-14/S1/FSL/UN/706,17178,18192,11890,11890,59150,30581,19312,20388,12875,83156
15,Sudan,2,2014,SUD-14/S1/P/NGO/708,20430,25538,27580,28602,102150,0,0,0,0,0
15,Sudan,2,2014,SUD-14/S1/RMS/NGO/710,500,700,1380,1500,4080,500,700,1380,1500,4080
15,Sudan,2,2014,SUD-14/S1/WASH/NGO/714,2950,4130,2124,2596,11800,2950,4130,2124,2596,11800
15,Sudan,2,2014,SUD-14/S1/RRR/NGO/720,3000,3750,1125,1125,9000,2687,4032,1120,1120,8959
15,Sudan,2,2014,SUD-14/S1/N/NGO/724,2050,3750,900,1250,7950,829,6490,2050,2149,11518
15,Sudan,2,2014,SUD-14/S1/CCS/UN/725,77000,63000,27600,32400,200000,262474,214752,94082,110444,681752
15,Sudan,2,2014,SUD-14/S1/H/NGO/727,32717,47081,8758,8758,97314,17779,39633,11909,11910,81231
15,Sudan,2,2014,SUD-14/S1/WASH/NGO/744,13640,20461,8139,12888,55128,11200,12740,16900,18150,58990
15,Sudan,2,2014,SUD-14/S1/FSL/UN/753,60711,63189,26550,26550,177000,61225,63725,26775,26775,178500
15,Sudan,2,2014,SUD-14/S1/N/NGO/765,860,860,13455,14005,29180,321,853,8249,8584,18007
15,Sudan,2,2014,SUD-14/S1/NFI/NGO/779,2690,4097,4951,5262,17000,2410,3490,4738,5012,15650
15,Sudan,2,2014,SUD-14/S1/H/NGO/784,32480,163430,19500,27590,243000,38424,72104,25494,36524,172546
15,Sudan,2,2014,SUD-14/S1/E/NGO/787,100,100,4000,4000,8200,122,80,3740,3822,7764
15,Sudan,2,2014,SUD-14/S1/P/UN/797,3750,2500,36900,24600,67750,2280,1822,38767,31719,74588
15,Sudan,2,2014,SUD-14/S1/N/NGO/799,1034,12275,17513,17512,48334,2301,34129,16494,16853,69777
15,Sudan,2,2014,SUD-14/S1/WASH/UN/803,12991,19795,11518,17556,61860,10349,18726,10102,10102,49279
15,Sudan,2,2014,SUD-14/S1/NFI/NGO/810,31408,62290,30331,45495,169524,0,0,0,0,0
15,Sudan,2,2014,SUD-14/S1/E/NGO/817,160,160,4000,4000,8320,160,160,4000,4000,8320
15,Sudan,2,2014,SUD-14/S1/RMS/UN/824,1150,3675,995,1275,7095,733,2375,497,2317,5922
15,Sudan,2,2014,SUD-14/S1/E/NGO/827,130,110,3500,10600,14340,202,114,3500,10600,14416
15,Sudan,2,2014,SUD-14/S1/H/UN/832,140,27245,3378,6757,37520,140,19185,2478,6293,28096
15,Sudan,2,2014,SUD-14/S1/RMS/UN/840,3780,3780,500,500,8560,3759,3759,769,769,9056
15,Sudan,2,2014,SUD-14/S1/RMS/NGO/842,100,190,45,45,380,120,174,11,50,355
15,Sudan,2,2014,SUD-14/S1/N/NGO/846,4993,14408,7009,6738,33148,7378,7536,19143,19926,53983
15,Sudan,2,2014,SUD-14/S1/P/NGO/849,14824,9883,8884,7589,41180,0,0,0,0,0
15,Sudan,2,2014,SUD-14/S1/H/NGO/856,20410,22111,30615,33168,106304,19400,21250,29750,32700,103100
15,Sudan,2,2014,SUD-14/S1/NFI/NGO/861,20600,30900,25750,25750,103000,7654,11482,9567,9567,38270
15,Sudan,2,2014,SUD-14/S1/N/NGO/862,340,1140,3800,3800,9080,200,500,1927,1928,4555
15,Sudan,2,2014,SUD-14/S1/E/NGO/870,420,350,850,1100,2720,520,430,1554,1522,4026
15,Sudan,2,2014,SUD-14/S1/E/NGO/875,60,40,1500,1500,3100,332,718,684,1266,3000
15,Sudan,2,2014,SUD-14/S1/NFI/NGO/876,4039,6059,759,759,11616,4261,6331,791,792,12175
15,Sudan,2,2014,SUD-14/S1/FSL/NGO/884,6273,9409,1250,1250,18182,5285,7927,1053,1054,15319
15,Sudan,2,2014,SUD-14/S1/RMS/UN/886,1445,1445,2805,2805,8500,1445,1445,2805,2805,8500
15,Sudan,2,2014,SUD-14/S1/FSL/NGO/890,2016,2184,2016,2184,8400,1827,3065,1976,2125,8993
15,Sudan,2,2014,SUD-14/S1/RRR/NGO/908,1937,3875,5344,5344,16500,0,0,0,0,0
15,Sudan,2,2014,SUD-14/S1/WASH/NGO/912,9450,13450,3650,3850,30400,5118,7888,3550,2064,18620
15,Sudan,2,2014,SUD-14/S1/P/UN/924,2500,10500,3000,5200,21200,990,4970,1833,3370,11163
15,Sudan,2,2014,SUD-14/S1/H/NGO/950,52542,56920,26271,28460,164193,36800,43650,22495,23413,126358
15,Sudan,2,2014,SUD-14/S1/FSL/NGO/955,4000,4800,8624,8976,26400,1838,3257,5862,6090,17047
15,Sudan,2,2014,SUD-14/S1/H/NGO/961,8020,9261,6875,6876,31032,8544,9831,7258,7356,32989
15,Sudan,2,2014,SUD-14/S1/H/NGO/964,103200,111800,51600,55900,322500,132374,136438,55634,69362,393808
15,Sudan,2,2014,SUD-14/S1/FSL/NGO/966,23671,22337,27084,23208,96300,33124,31898,29442,28217,122681
15,Sudan,2,2014,SUD-14/S1/P/NGO/967,9549,13240,530,695,24014,8890,11714,1370,1400,23374
15,Sudan,2,2014,SUD-14/S1/N/NGO/984,14356,76742,19758,20566,131422,35909,91097,8544,9660,145210
15,Sudan,2,2014,SUD-14/S1/H/NGO/985,57951,60316,41964,43678,203909,92381,107705,56938,61105,318129
15,Sudan,2,2014,SUD-14/S1/P/NGO/994,175,325,6247,6503,13250,175,325,6329,6921,13750
15,Sudan,2,2014,SUD-14/SSp/CCS/UN/995,0,0,0,0,0,0,0,0,0,0
15,Sudan,2,2014,SUD-14/SSp/H/UN/999,461326,377450,170627,139604,1149007,455200,375540,170700,136560,1138000
15,Sudan,2,2014,SUD-14/SSp/N/UN/1000,0,0,7650,7350,15000,0,0,7885,7907,15792
15,Sudan,2,2014,SUD-14/SSp/NFI/UN/1004,37500,37500,37500,37500,150000,37500,37500,37500,37500,150000
15,Sudan,2,2014,SUD-14/SSp/L/UN/1010,21600,21600,0,0,43200,0,0,0,0,0
15,Sudan,2,2014,SUD-14/SSp/WASH/UN/1012,35280,36720,62720,65280,200000,35280,36720,62720,65280,200000
15,Sudan,2,2014,SUD-14/SSp/FSL/UN/1013,87500,91072,59524,59524,297620,0,0,0,0,0
15,Sudan,2,2014,SUD-14/SSp/FSL/UN/1014,102333,98321,42998,42998,286650,61225,63725,26775,26775,178500
15,Sudan,1,2014,SUD-14/R/H/UN/1017,1500,12816,1000,6500,21816,200,10200,200,6000,16600
15,Sudan,1,2014,SUD-14/R/E/UN/1018,50,50,6585,6635,13320,65,15,8462,7723,16265
15,Sudan,1,2014,SUD-14/R/P/UN/1019,18118,21918,13080,15180,68296,25160,20585,12499,14709,72953
15,Sudan,1,2014,SUD-14/R/H/UN/1020,17556,28644,9662,10138,66000,18448,30097,10153,10652,69350
15,Sudan,1,2014,SUD-14/R/H/UN/1022,48960,53040,33320,34680,170000,47996,52204,32732,34068,167000
15,Sudan,1,2014,SUD-14/R/N/INGO/1024,0,790,2347,2719,5856,0,0,721,911,1632
15,Sudan,1,2014,SUD-14/R/N/UN/1025,0,2100,4463,4463,11026,107,4314,7641,7642,19704
15,Sudan,1,2014,SUD-14/R/NFI/INGO/1026,3500,4000,1125,1375,10000,17544,20049,6000,6530,50123
15,Sudan,1,2014,SUD-14/R/CCS/UN/1027,15750,19250,6900,8100,50000,49302,60258,21599,25355,156514
15,Sudan,2,2014,SUD-14/S1/NFI/UN/1029,288750,288750,288750,288750,1155000,288750,288750,288750,288750,1155000
15,Sudan,1,2014,SUD-14/R/E/INGO/1030,30,30,1500,1500,3060,37,23,1500,1500,3060
15,Sudan,1,2014,SUD-14/R/WASH/UN/1032,33975,78975,18525,18525,150000,57967,62797,31106,31106,182976
15,Sudan,2,2014,SUD-14/S1/N/UN/1034,0,0,0,0,0,0,625883,116666,112090,854639
15,Sudan,1,2014,SUD-14/R/WASH/INGO/1035,6457,8905,6314,7475,29151,3244,3396,2622,2688,11950
15,Sudan,2,2014,SUD-14/S1/N/INGO/1037,6068,6316,1569,1633,15586,2564,3604,676,929,7773
15,Sudan,1,2014,SUD-14/R/NFI/UN/1038,2500,2500,2500,2500,10000,2500,2500,2500,2500,10000
15,Sudan,1,2014,SUD-14/R/NFI/INGO/1039,5463,6683,6488,8368,27002,4438,7240,5371,6305,23354
15,Sudan,1,2014,SUD-14/R/FSL/INGO/1040,16000,17000,20000,22000,75000,16000,17000,20000,22000,75000
15,Sudan,1,2014,SUD-14/R/WASH/INGO/1041,7650,9350,0,0,17000,5998,6886,0,0,12884
15,Sudan,1,2014,SUD-14/R/WASH/UN/1043,2550,5100,4250,5100,17000,2000,4500,2500,3000,12000
15,Sudan,1,2014,SUD-14/R/N/INGO/1044,50,450,1015,1056,2571,602,3655,915,1231,6403
15,Sudan,1,2014,SUD-14/R/H/UN/1045,26775,25750,8900,8575,70000,26120,24960,8700,8380,68160
15,Sudan,1,2014,SUD-14/R/H/UN/1046,10709,10263,11601,12047,44620,5988,5747,6498,6746,24979
15,Sudan,1,2014,SUD-14/R/H/UN/1047,1179346,1115028,221778,206381,2722533,1420752,1367663,285549,253281,3327245
15,Sudan,2,2014,SUD-14/S2/H/INGO/1048,14612,24626,4098,3939,47275,15882,19410,3000,3604,41896
15,Sudan,2,2014,SUD-14/S2/WASH/INGO/1049,12355,15725,11960,11960,52000,12355,15725,11960,11960,52000
15,Sudan,2,2014,SUD-14/S2/WASH/UN/1050,5880,6120,9000,9000,30000,14056,16952,10865,13159,55032
15,Sudan,2,2014,SUD-14/S2/WASH/INGO/1051,4890,5711,2389,4138,17128,5300,6200,2900,4400,18800
15,Sudan,2,2014,SUD-14/S2/WASH/UN/1052,4780,7390,3911,5959,22040,210,380,205,205,1000
15,Sudan,2,2014,SUD-14/S2/WASH/NGO/1053,14994,22491,1666,2499,41650,14994,22491,1666,2499,41650
15,Sudan,2,2014,SUD-14/S2/H/UN/1054,44688,46512,33712,35088,160000,44306,46113,33423,34788,158630
15,Sudan,2,2014,SUD-14/S2/H/INGO/1055,35592,57728,9076,9832,112228,45369,76681,21583,23427,167060
15,Sudan,2,2014,SUD-14/S2/H/UN/1056,0,92153,46413,44591,183157,0,27145,14620,14046,55811
15,Sudan,2,2014,SUD-14/S2/E/NGO/1057,120,80,2000,3800,6000,130,70,2200,3600,6000
15,Sudan,2,2014,SUD-14/S2/H/UN/1059,500,18987,200,240,19927,350,16798,100,240,17488
15,Sudan,2,2014,SUD-14/S2/E/INGO/1060,75,75,2583,1564,4297,75,75,2583,1564,4297
15,Sudan,2,2014,SUD-14/S2/NFI/INGO/1061,4320,6560,2400,2720,16000,4207,6812,2309,2617,15945
15,Sudan,2,2014,SUD-14/S2/E/INGO/1062,65,70,1750,1250,3135,141,137,3238,3299,6815
15,Sudan,2,2014,SUD-14/S2/E/INGO/1064,122,86,3856,3617,7681,209,44,4434,4544,9231
15,Sudan,2,2014,SUD-14/S2/NFI/UN/1065,9250,9250,9250,9250,37000,9250,9250,9250,9250,37000
15,Sudan,2,2014,SUD-14/S2/N/INGO/1066,8402,14376,5645,6365,34788,4144,27373,7763,8080,47360
15,Sudan,2,2014,SUD-14/S2/NFI/NGO/1067,43749,61248,31499,38499,174995,43749,61248,31499,38499,174995
15,Sudan,2,2014,SUD-14/S2/N/INGO/1068,8000,15860,6017,6689,36566,0,704,2047,2649,5400
15,Sudan,2,2014,SUD-14/S2/NFI/NGO/1069,2150,2350,2000,2150,8650,2150,2350,2000,2150,8650
15,Sudan,2,2014,SUD-14/S2/N/INGO/1070,0,22559,0,0,22559,0,10962,4223,5885,21070
15,Sudan,2,2014,SUD-14/S2/N/INGO/1071,23761,26240,2522,3808,56331,7105,17558,3457,3845,31965
15,Sudan,2,2014,SUD-14/S2/NFI/INGO/1072,9000,13500,11250,11250,45000,4570,6856,5712,5712,22850
15,Sudan,2,2014,SUD-14/S2/NFI/INGO/1073,3705,4781,3536,3383,15405,3422,4432,3213,3148,14215
15,Sudan,2,2014,SUD-14/S2/NFI/NGO/1074,7350,9138,1182,2195,19865,2550,5000,3500,3500,14550
15,Sudan,2,2014,SUD-14/S2/FSL/UN/1075,27260,28540,18600,18600,93000,29035,30340,19790,19790,98955
15,Sudan,2,2014,SUD-14/S2/CCS/UN/1076,57750,47250,20700,24300,150000,86081,70430,30855,36221,223587
15,Sudan,2,2014,SUD-14/S2/P/NGO/1077,400,4700,350,1050,6500,400,4700,350,1050,6500
15,Sudan,2,2014,SUD-14/S2/P/UN/1078,600,4500,400,500,6000,600,4735,400,1500,7235
15,Sudan,2,2014,SUD-14/S2/P/UN/1079,4500,3000,6500,5400,19400,4500,3000,6500,5400,19400
15,Sudan,2,2014,SUD-14/S2/P/NGO/1080,1900,2830,1800,2000,8530,1900,2820,1800,2000,8520
15,Sudan,2,2014,SUD-14/S2/P/UN/1081,15000,15000,17916,17916,65832,2280,1882,38767,31719,74648
15,Sudan,2,2014,SUD-14/S2/P/NGO/1082,2450,4850,750,950,9000,1600,1920,726,968,5214
15,Sudan,2,2014,SUD-14/S2/P/NGO/1084,105,155,3040,4000,7300,710,660,3211,5106,9687
15,Sudan,2,2014,SUD-14/S2/RMS/UN/1086,1140,1200,1860,1800,6000,1226,1103,1962,1839,6130
15,Sudan,1,2014,SUD-14/R/NFI/UN/1087,6000,6000,6000,6000,24000,6000,6000,6000,6000,24000
15,Sudan,1,2014,SUD-14/R/RMS/UN/1088,7564,17087,4523,12151,41325,14406,24286,6174,12674,57540
15,Sudan,2,2015,SUD-15/HSD20/SSp/E/UN/1093,0,0,27000,27000,54000,466,324,26378,28576,55744
15,Sudan,2,2015,SUD-15/HSD20/SSp/FSL/UN/1095,113190,117810,49500,49500,330000,0,0,0,0,0
15,Sudan,2,2015,SUD-15/HSD20/SSp/H/UN/1096,78848,118272,122931,127949,448000,77284,114366,118890,122650,433190
15,Sudan,2,2015,SUD-15/HSD20/SSp/N/UN/1097,0,12280,6140,6140,24560,0,0,7967,7967,15934
15,Sudan,2,2015,SUD-15/HSD20/SSp/RMS/UN/1099,2250,2250,2250,2250,9000,2250,2250,2250,2250,9000
15,Sudan,2,2015,SUD-15/HSD20/SSp/WASH/UN/1100,36404,37882,54605,56823,185714,69655,72479,104483,108723,355340
15,Sudan,2,2015,SUD-15/HSD20/SSp/L/UN/1101,21000,21000,0,0,42000,20279,20279,0,0,40558
15,Sudan,2,2015,SUD-15/HSD20/SSp/ESNFIs/UN/1102,250000,250000,250000,250000,1000000,154597,154597,154597,154598,618389
15,Sudan,2,2015,SUD-15/HSD20/SSp/FSL/UN/1103,0,0,0,0,0,0,0,0,0,0
15,Sudan,2,2015,SUD-15/HSD20/SSp/P/UN/1106,226205,751161,978187,1091290,3046843,0,0,0,0,0
15,Sudan,2,2015,SUD-15/HSD20/SSp/E/UN/1108,0,0,0,0,0,0,0,0,0,0
15,Sudan,2,2015,SUD-15/HSD20/SSp/RMS/UN/1109,178897,178897,178897,178897,715588,178897,178897,178897,178897,715588
15,Sudan,2,2015,SUD-15/HSD20/SSp/H/UN/1110,1793683,1868684,402774,434859,4500000,1793683,1868684,402774,434859,4500000
15,Sudan,2,2015,SUD-15/HSD20/SSp/N/UN/1111,0,0,0,0,0,0,0,0,0,0
15,Sudan,2,2015,SUD-15/HSD20/SSp/WASH/UN/1112,878472,914328,885528,921672,3600000,342848,356841,345601,359708,1404998
15,Sudan,2,2015,SUD-15/HSD20/SSp/P/UN/1114,0,19520,0,4880,24400,0,19520,0,4880,24400
15,Sudan,2,2015,SUD-15/HSD20/SSp/H/UN/1115,37566,39100,56350,58560,191576,21570,22451,32355,33624,110000
15,Sudan,2,2015,SUD-15/HSD20/SSp/H/UN/1116,1875,13984,10,68,15937,1875,25000,50,853,27778
15,Sudan,2,2015,SUD-15/HSD20/SSp/RMS/UN/1117,0,14800,0,3700,18500,0,14700,0,3800,18500
15,Sudan,2,2015,SUD-15/HSD20/SSp/ESNFIs/UN/1118,27000,28000,27000,28000,110000,27000,28000,27000,28000,110000
15,Sudan,1,2015,SUD-15/HSD20/R/P/UN/1119,5120,5120,4280,4526,19046,7662,8994,8319,10189,35164
15,Sudan,2,2015,SUD-15/HSD20/S1/ESNFIs/INGO/1120,10118,15176,12647,12647,50588,10014,15022,12517,12517,50070
15,Sudan,2,2015,SUD-15/HSD20/S1/RMS/INGO/1123,5000,8950,5760,6000,25710,5000,8950,5760,6000,25710
15,Sudan,2,2015,SUD-15/HSD20/S1/N/INGO/1127,0,1227,4539,5546,11312,0,369,3943,4151,8463
15,Sudan,2,2015,SUD-15/HSD20/S1/WASH/INGO/1128,16775,18625,19800,19800,75000,15399,17098,18176,18177,68850
15,Sudan,2,2015,SUD-15/HSD20/S1/RMS/NGO/1130,1000,1500,800,1200,4500,900,1600,800,1200,4500
15,Sudan,2,2015,SUD-15/HSD20/S1/ESNFIs/NGO/1132,3800,4700,1100,1150,10750,1720,2400,1300,1400,6820
15,Sudan,2,2015,SUD-15/HSD20/S1/E/NGO/1134,150,100,1350,1650,3250,149,101,1400,1600,3250
15,Sudan,2,2015,SUD-15/HSD20/S1/H/INGO/1135,34250,41861,8158,9971,94240,23282,23031,7764,9299,63376
15,Sudan,2,2015,SUD-15/HSD20/S1/H/INGO/1136,143236,148175,98783,103722,493916,79979,98159,192406,203388,573932
15,Sudan,2,2015,SUD-15/HSD20/S1/N/INGO/1139,2800,4600,1200,1800,10400,2481,3889,800,641,7811
15,Sudan,2,2015,SUD-15/HSD20/S1/WASH/INGO/1141,8670,10930,2300,3600,25500,4236,5900,400,600,11136
15,Sudan,2,2015,SUD-15/HSD20/S1/ESNFIs/INGO/1142,10891,13874,3000,3500,31265,3138,3982,857,1018,8995
15,Sudan,2,2015,SUD-15/HSD20/S1/WASH/NGO/1145,6106,7211,3632,3229,20178,6106,7211,3632,3229,20178
15,Sudan,2,2015,SUD-15/HSD20/S1/RMS/INGO/1146,438,545,748,804,2535,310,743,615,775,2443
15,Sudan,2,2015,SUD-15/HSD20/S1/P/NGO/1152,15590,10290,0,0,25880,10722,15805,0,0,26527
15,Sudan,2,2015,SUD-15/HSD20/S1/ESNFIs/INGO/1153,7477,9649,7129,6820,31075,6094,7926,5687,5574,25281
15,Sudan,2,2015,SUD-15/HSD20/S1/WASH/INGO/1155,8400,9240,11340,13020,42000,8920,9812,12042,13826,44600
15,Sudan,2,2015,SUD-15/HSD20/S1/H/INGO/1156,26586,27672,22971,22070,99299,52613,64305,10980,11284,139182
15,Sudan,2,2015,SUD-15/HSD20/S1/N/INGO/1157,0,5310,11639,17458,34407,0,5986,11954,13862,31802
15,Sudan,2,2015,SUD-15/HSD20/S1/E/INGO/1158,124,100,3734,3121,7079,192,32,4805,3930,8959
15,Sudan,2,2015,SUD-15/HSD20/S1/P/INGO/1162,4179,7126,1070,1070,13445,3960,6770,1022,1022,12774
15,Sudan,2,2015,SUD-15/HSD20/S1/P/INGO/1164,760,1544,720,720,3744,1244,3819,980,863,6906
15,Sudan,2,2015,SUD-15/HSD20/S1/E/INGO/1165,59,34,1348,1168,2609,62,82,1348,1168,2660
15,Sudan,2,2015,SUD-15/HSD20/S1/WASH/INGO/1166,8501,10763,16117,16158,51539,15870,18676,28840,28766,92152
15,Sudan,2,2015,SUD-15/HSD20/S1/H/NGO/1172,35697,37152,34986,37882,145717,30827,35973,15559,16434,98793
15,Sudan,2,2015,SUD-15/HSD20/S1/P/NGO/1173,940,1210,6830,7810,16790,814,1088,5065,6009,12976
15,Sudan,2,2015,SUD-15/HSD20/S1/P/NGO/1174,5950,7800,650,710,15110,5950,7800,650,710,15110
15,Sudan,2,2015,SUD-15/HSD20/S1/H/NGO/1176,3300,6950,3650,4600,18500,14018,16842,9985,7647,48492
15,Sudan,2,2015,SUD-15/HSD20/S1/H/INGO/1178,127074,202826,33022,34485,397407,63547,75674,63535,69697,272453
15,Sudan,2,2015,SUD-15/HSD20/S1/WASH/INGO/1180,23895,33175,23002,34565,114637,24268,34401,22485,34533,115687
15,Sudan,2,2015,SUD-15/HSD20/S1/ESNFIs/NGO/1181,2225,4200,1575,2500,10500,2225,4200,1575,2500,10500
15,Sudan,2,2015,SUD-15/HSD20/S1/P/NGO/1182,12351,12230,13215,12857,50653,10489,10383,11199,10929,43000
15,Sudan,2,2015,SUD-15/HSD20/S1/N/INGO/1183,8023,8412,4475,5470,26380,7892,8462,3956,5500,25810
15,Sudan,2,2015,SUD-15/HSD20/S1/RMS/NGO/1184,8676,11156,6044,7827,33703,7348,14724,5871,8396,36339
15,Sudan,2,2015,SUD-15/HSD20/S1/WASH/INGO/1185,8845,9200,13260,13805,45110,8845,9200,13260,13805,45110
15,Sudan,2,2015,SUD-15/HSD20/S1/P/NGO/1187,1375,1905,480,730,4490,1375,1905,480,730,4490
15,Sudan,2,2015,SUD-15/HSD20/S1/N/NGO/1193,1715,2151,2705,2708,9279,2366,4892,2505,3009,12772
15,Sudan,2,2015,SUD-15/HSD20/S1/H/NGO/1194,55122,81900,18800,27590,183412,34852,94661,17157,37410,184080
15,Sudan,2,2015,SUD-15/HSD20/S1/WASH/UN/1195,173442,260158,67443,101171,602214,174800,253930,68360,106744,603834
15,Sudan,2,2015,SUD-15/HSD20/S1/H/NGO/1197,72917,78993,36458,39497,227865,86837,94073,43418,47037,271365
15,Sudan,2,2015,SUD-15/HSD20/S1/N/INGO/1199,569,25467,9178,9178,44392,1607,14929,11784,11707,40027
15,Sudan,2,2015,SUD-15/HSD20/S1/P/NGO/1202,1300,1300,3800,3800,10200,1016,1018,3659,3365,9058
15,Sudan,2,2015,SUD-15/HSD20/S1/H/INGO/1204,37748,39288,7732,8047,92815,38124,55537,29006,28379,151046
15,Sudan,2,2015,SUD-15/HSD20/S1/N/INGO/1205,2551,2551,1666,1734,8502,472,831,739,979,3021
15,Sudan,2,2015,SUD-15/HSD20/S1/H/INGO/1211,34863,52328,9415,9046,105652,30934,29033,30138,42200,132305
15,Sudan,2,2015,SUD-15/HSD20/S1/P/NGO/1212,9900,11907,16726,16710,55243,9920,11917,16720,16715,55272
15,Sudan,2,2015,SUD-15/HSD20/S1/P/NGO/1213,15340,10227,11505,26847,63919,7998,15636,23994,32352,79980
15,Sudan,2,2015,SUD-15/HSD20/S1/H/NGO/1221,57503,59850,11778,12258,141389,31851,43958,18318,20221,114348
15,Sudan,2,2015,SUD-15/HSD20/S1/ESNFIs/NGO/1223,804,3600,2000,2400,8804,770,3200,2000,2150,8120
15,Sudan,2,2015,SUD-15/HSD20/S1/N/INGO/1224,87749,91330,71794,74725,325598,51934,122940,75439,82056,332369
15,Sudan,2,2015,SUD-15/HSD20/S1/WASH/INGO/1228,3268,3548,1214,1307,9337,3268,3548,1214,1307,9337
15,Sudan,2,2015,SUD-15/HSD20/S1/RMS/INGO/1229,1032,1963,2096,2175,7266,830,976,1170,1174,4150
15,Sudan,2,2015,SUD-15/HSD20/S1/N/NGO/1230,650,8410,7210,7210,23480,0,0,0,0,0
15,Sudan,2,2015,SUD-15/HSD20/S1/E/INGO/1231,96,122,3000,3000,6218,122,89,2558,3432,6201
15,Sudan,2,2015,SUD-15/HSD20/S1/RMS/INGO/1232,5502,5669,2667,2834,16672,3741,5391,4628,4846,18606
15,Sudan,2,2015,SUD-15/HSD20/S1/ESNFIs/UN/1234,164,1840,480,516,3000,5996,10244,3249,5496,24985
15,Sudan,2,2015,SUD-15/HSD20/S1/E/INGO/1239,280,280,2873,3570,7003,368,348,4397,2704,7817
15,Sudan,2,2015,SUD-15/HSD20/S1/ESNFIs/INGO/1241,2221,3321,3361,3362,12265,2270,3374,3410,3410,12464
15,Sudan,2,2015,SUD-15/HSD20/S1/P/NGO/1242,1140,1596,876,948,4560,1325,2004,626,921,4876
15,Sudan,2,2015,SUD-15/HSD20/S1/H/UN/1245,34560,51840,45864,47736,180000,34206,51310,45395,47248,178159
15,Sudan,2,2015,SUD-15/HSD20/S1/P/NGO/1247,2317,3607,3085,4715,13724,3513,4131,3628,4098,15370
15,Sudan,2,2015,SUD-15/HSD20/S1/N/INGO/1255,25776,26826,1693,1691,55986,58450,70369,1128,1428,131375
15,Sudan,2,2015,SUD-15/HSD20/S1/WASH/NGO/1256,15101,10125,4012,2644,31882,15101,10125,4012,2644,31882
15,Sudan,2,2015,SUD-15/HSD20/S1/N/INGO/1257,0,2810,9473,10793,23076,0,2147,10664,12855,25666
15,Sudan,2,2015,SUD-15/HSD20/S1/H/INGO/1261,10999,18557,13920,13686,57162,10579,18373,13422,13302,55676
15,Sudan,2,2015,SUD-15/HSD20/S1/P/NGO/1262,525,6325,300,400,7550,600,7000,350,450,8400
15,Sudan,2,2015,SUD-15/HSD20/S1/E/NGO/1263,537,1537,1064,1964,5102,80,63,2580,3848,6571
15,Sudan,2,2015,SUD-15/HSD20/S1/RMS/NGO/1267,1470,2686,1200,1200,6556,1547,4629,4356,4010,14542
15,Sudan,2,2015,SUD-15/HSD20/S1/ESNFIs/NGO/1268,2158,3022,1382,2071,8633,22000,35000,25000,54132,136132
15,Sudan,2,2015,SUD-15/HSD20/S1/N/INGO/1278,0,2014,4398,4226,10638,0,1696,4334,4528,10558
15,Sudan,2,2015,SUD-15/HSD20/S1/WASH/INGO/1279,28883,30061,5916,6157,71017,23106,24048,4732,4925,56811
15,Sudan,2,2015,SUD-15/HSD20/S1/ESNFIs/INGO/1280,14237,14816,2913,3034,35000,11414,12472,2836,2995,29717
15,Sudan,2,2015,SUD-15/HSD20/S1/RMS/UN/1281,1070,1910,1025,1025,5030,2397,4338,2293,2387,11415
15,Sudan,2,2015,SUD-15/HSD20/S1/CCS/UN/1282,154000,126000,64800,55200,400000,93269,146040,173529,187910,600748
15,Sudan,2,2015,SUD-15/HSD20/S1/P/INGO/1295,6520,9540,3400,4100,23560,0,0,0,0,0
15,Sudan,2,2015,SUD-15/HSD20/S1/N/INGO/1296,12041,14717,3597,4396,34751,1886,5286,4096,5005,16273
15,Sudan,2,2015,SUD-15/HSD20/S1/FSL/NGO/1302,8640,9360,5760,6240,30000,11151,11501,7342,7893,37887
15,Sudan,2,2015,SUD-15/HSD20/S1/FSL/NGO/1304,13215,19822,5506,5507,44050,12928,19561,5158,5200,42847
15,Sudan,2,2015,SUD-15/HSD20/S1/FSL/NGO/1310,9034,15492,6816,13738,45080,9034,15492,6816,13738,45080
15,Sudan,2,2015,SUD-15/HSD20/S1/FSL/INGO/1312,9057,7662,3049,3092,22860,9999,10833,4285,4643,29760
15,Sudan,2,2015,SUD-15/HSD20/S1/FSL/INGO/1319,15318,17982,5106,5994,44400,10435,11270,925,1010,23640
15,Sudan,2,2015,SUD-15/HSD20/S1/FSL/INGO/1322,2982,6080,8522,9151,26735,2982,6080,8522,9151,26735
15,Sudan,2,2015,SUD-15/HSD20/S1/FSL/INGO/1325,11200,13400,6400,6416,37416,14152,13920,5464,10594,44130
15,Sudan,1,2015,SUD-15/HSD20/R/E/UN/1326,0,0,1750,1750,3500,0,0,2787,2547,5334
15,Sudan,1,2015,SUD-15/HSD20/R/N/UN/1327,0,575,5462,5463,11500,0,558,5610,5390,11558
15,Sudan,2,2015,SUD-15/HSD20/S1/FSL/INGO/1330,14190,17028,19157,20575,70950,14190,17028,19157,20575,70950
15,Sudan,2,2015,SUD-15/HSD20/S1/FSL/INGO/1331,3818,4581,8398,8653,25450,3818,4581,8398,8653,25450
15,Sudan,2,2015,SUD-15/HSD20/S1/FSL/NGO/1336,2573,2677,1100,1150,7500,1080,1110,620,840,3650
15,Sudan,2,2014,SUD-14/HSD20/S1/H/INGO/1337,9266,9644,6710,6984,32604,0,0,0,0,0
15,Sudan,2,2014,SUD-14/HSD20/S1/H/INGO/1338,112633,117233,23080,24010,276956,0,0,0,0,0
15,Sudan,2,2014,SUD-14/HSD20/S1/N/INGO/1339,10242,17564,5718,9156,42680,6157,15832,11995,20615,54599
15,Sudan,2,2014,SUD-14/HSD20/S1/WASH/UN/1340,36128,47689,30347,30347,144511,37140,48150,31500,32300,149090
15,Sudan,1,2015,SUD-15/HSD20/R/WASH/INGO/1373,12495,12495,4998,5712,35700,7359,7894,8995,8553,32801
15,Sudan,1,2015,SUD-15/HSD20/R/N/UN/1374,0,6000,796,764,7560,0,7104,802,758,8664
15,Sudan,1,2015,SUD-15/HSD20/R/RMS/UN/1375,100,790,2055,2055,5000,303,342,2093,1621,4359
15,Sudan,1,2015,SUD-15/HSD20/R/RMS/NGO/1377,800,2050,950,1200,5000,1417,3277,1665,2499,8858
15,Sudan,1,2015,SUD-15/HSD20/R/RMS/UN/1380,1536,2343,2020,2181,8080,1323,1964,1763,1826,6876
15,Sudan,1,2015,SUD-15/HSD20/R/RMS/UN/1383,0,150,794,794,1738,0,255,504,484,1243
15,Sudan,1,2015,SUD-15/HSD20/R/P/UN/1384,1500,1500,3500,3500,10000,2195,3990,2652,2420,11257
15,Sudan,2,2015,SUD-15/HSD20/S2/L/UN/1388,840,840,0,0,1680,981,981,0,0,1962
15,Sudan,2,2015,SUD-15/HSD20/S2/RMS/NGO/1394,1000,1200,600,600,3400,750,1450,620,580,3400
15,Sudan,2,2015,SUD-15/HSD20/S2/H/UN/1401,0,0,2374681,2471606,4846287,0,0,2378922,2476021,4854943
15,Sudan,2,2015,SUD-15/HSD20/S2/ESNFIs/NGO/1403,3300,7425,2475,3300,16500,2671,6010,2003,2671,13355
15,Sudan,2,2015,SUD-15/HSD20/S2/WASH/NGO/1404,2672,6179,3140,4709,16700,2874,7269,3463,4959,18565
15,Sudan,2,2015,SUD-15/HSD20/S2/N/INGO/1405,1161,4386,4288,5353,15188,1558,4653,4293,5084,15588
15,Sudan,2,2015,SUD-15/HSD20/S2/WASH/UN/1406,101667,152683,83264,124871,462485,101467,152483,83064,124671,461685
15,Sudan,2,2015,SUD-15/HSD20/S2/ESNFIs/NGO/1410,1063,7970,1701,2550,13284,658,4812,850,1530,7850
15,Sudan,2,2015,SUD-15/HSD20/S2/H-P/UN/1412,820,11631,2160,2879,17490,700,19970,1260,5050,26980
15,Sudan,2,2015,SUD-15/HSD20/S2/RMS/UN/1413,2000,17100,1000,6000,26100,205,12784,33,4600,17622
15,Sudan,2,2015,SUD-15/HSD20/S2/CCS/UN/1414,15150,18131,20851,20868,75000,42093,50375,57933,57980,208381
15,Sudan,2,2015,SUD-15/HSD20/S2/H/INGO/1416,6285,15320,9820,7857,39282,8217,23305,11376,10011,52909
15,Sudan,2,2015,SUD-15/HSD20/S2/E/NGO/1418,256,275,1475,1403,3409,22,28,1662,1725,3437
15,Sudan,2,2015,SUD-15/HSD20/S2/RMS/INGO/1419,80,96,137,140,453,100,230,708,614,1652
15,Sudan,2,2015,SUD-15/HSD20/S2/RMS/UN/1420,1789,2692,3798,4007,12286,1389,1792,3198,3407,9786
15,Sudan,2,2015,SUD-15/HSD20/S2/RMS/UN/1421,19200,30400,51200,59200,160000,18073,35252,54219,55863,163407
15,Sudan,2,2015,SUD-15/HSD20/S2/RMS/UN/1422,5145,6143,2205,2632,16125,7100,7477,3043,3205,20825
15,Sudan,2,2015,SUD-15/HSD20/S2/N/INGO/1423,0,0,1668,2033,3701,0,0,1568,1738,3306
15,Sudan,2,2015,SUD-15/HSD20/S2/WASH/UN/1427,19001,34383,18178,18920,90482,19428,35023,18320,19133,91904
15,Sudan,2,2015,SUD-15/HSD20/S2/ESNFIs/NGO/1432,2380,3350,2000,2700,10430,2380,3350,2000,2700,10430
15,Sudan,2,2015,SUD-15/HSD20/S2/ESNFIs/INGO/1433,1176,1905,2681,2813,8575,1467,1905,2903,2915,9190
15,Sudan,2,2015,SUD-15/HSD20/S2/RMS/INGO/1435,30,15,1000,950,1995,20,25,1100,905,2050
15,Sudan,2,2015,SUD-15/HSD20/S2/RRR/INGO/1436,1422,1631,509,553,4115,1422,1631,509,553,4115
15,Sudan,2,2015,SUD-15/HSD20/S2/H/UN/1437,0,0,2374681,2471606,4846287,0,0,2378922,2476021,4854943
15,Sudan,2,2015,SUD-15/HSD20/S2/WASH/INGO/1440,11436,12523,14703,15788,54450,12821,14042,16484,17705,61052
15,Sudan,2,2015,SUD-15/HSD20/S2/H/UN/1443,29096,33946,30309,27884,121235,29125,33896,30267,27749,121037
15,Sudan,2,2015,SUD-15/HSD20/S2/RMS/NGO/1449,1900,2046,2749,2520,9215,555,640,5164,5070,11429
15,Sudan,2,2015,SUD-15/HSD20/S2/N/INGO/1453,0,41186,5192,5403,51781,4674,21356,19187,16258,61475
15,Sudan,2,2015,SUD-15/HSD20/S2/P/NGO/1454,328,756,384,576,2044,402,813,311,574,2100
15,Sudan,2,2015,SUD-15/HSD20/S2/H/INGO/1455,8698,11481,5845,8768,34792,6550,7830,6206,7520,28106
15,Sudan,2,2015,SUD-15/HSD20/S2/P/UN/1456,6720,9740,3700,4400,24560,7168,6929,5574,4225,23896
15,Sudan,2,2015,SUD-15/HSD20/S2/RRR/NGO/1457,6214,10000,4500,5500,26214,6214,10000,3100,3400,22714
15,Sudan,2,2015,SUD-15/HSD20/S2/ESNFIs/INGO/1458,1000,15000,12500,12500,41000,10066,15100,12583,12582,50331
15,Sudan,2,2015,SUD-15/HSD20/S2/H/NGO/1460,21015,24161,21872,22302,89350,14378,19194,17844,17312,68728
15,Sudan,2,2015,SUD-15/HSD20/S2/H/UN/1461,14000,23753,5569,5782,49104,15430,24005,9270,9508,58213
15,Sudan,2,2015,SUD-15/HSD20/S2/FSL/UN/1462,41777,43483,18270,18270,121800,44600,49630,20680,20270,135180
15,Sudan,2,2015,SUD-15/HSD20/S2/E-P/NGO/1466,85,65,2620,2770,5540,85,65,1311,2230,3691
15,Sudan,2,2015,SUD-15/HSD20/S2/ESNFIs/NGO/1471,3672,7584,4420,5184,20860,4251,5462,6542,4532,20787
15,Sudan,2,2015,SUD-15/HSD20/S2/ESNFIs/INGO/1474,377,495,624,624,2120,376,495,623,626,2120
15,Sudan,2,2015,SUD-15/HSD20/S2/WASH/INGO/1475,8550,9279,13361,13810,45000,8550,9279,13361,13810,45000
15,Sudan,2,2015,SUD-15/HSD20/S2/RMS/UN/1477,26000,37700,32800,33800,130300,31426,34968,31653,33554,131601
15,Sudan,2,2015,SUD-15/HSD20/S2/N/NGO/1481,950,1780,2230,1795,6755,914,1405,2138,1402,5859
15,Sudan,2,2015,SUD-15/HSD20/S2/E/NGO/1494,90,60,1400,1600,3150,92,60,1350,1650,3152
15,Sudan,2,2015,SUD-15/HSD20/S2/N/UN/1501,0,0,2300,2300,4600,0,0,2300,2300,4600
15,Sudan,2,2015,SUD-15/HSD20/S2/P/INGO/1502,5184,8746,1170,1170,16270,0,0,0,0,0
15,Sudan,2,2015,SUD-15/HSD20/S2/RRR/NGO/1510,2000,2500,1700,1300,7500,2600,2500,1580,1420,8100
15,Sudan,2,2015,SUD-15/HSD20/S2/E/INGO/1512,450,450,4000,4000,8900,543,601,9675,8312,19131
15,Sudan,1,2015,SUD-15/HSD20/R/H/INGO/1515,528,550,433,450,1961,490,655,410,448,2003
15,Sudan,1,2015,SUD-15/HSD20/R/H-WASH/UN/1516,117130,121910,126890,132070,498000,116663,119097,122717,122523,481000
15,Sudan,1,2015,SUD-15/HSD20/R/H/UN/1517,134035,151145,201053,226719,712952,315046,341301,230040,249209,1135596
15,Sudan,1,2016,SUD-16/HSD20/R/ESNFIs/UN/1520,189000,231000,126000,154000,700000,95000,115000,63000,77000,350000
15,Sudan,1,2016,SUD-16/HSD20/R/WASH/UN/1521,306298,306297,386400,386400,1385395,0,0,0,0,0
15,Sudan,1,2016,SUD-16/HSD20/R/N/UN/1522,0,12280,6140,6140,24560,0,12280,6140,6140,24560
15,Sudan,1,2016,SUD-16/HSD20/R/P/UN/1523,0,0,0,0,0,0,0,0,0,0
15,Sudan,1,2016,SUD-16/HSD20/R/E/UN/1524,0,0,27000,27000,54000,0,1,0,0,1
15,Sudan,2,2015,SUD-15/HSD20/S2/WASH/INGO/1525,8670,10930,2300,3600,25500,6125,8085,5000,5290,24500
15,Sudan,1,2016,SUD-16/HSD20/R/H/UN/1528,928320,891917,1005778,1046830,3872845,309000,698000,353000,340500,1700500
15,Sudan,1,2016,SUD-16/HSD20/R/FSL/UN/1529,0,0,0,0,0,0,0,0,0,0
15,Sudan,2,2016,SUD-16/HSD20/S1/N/INGO/1534,1578,6807,8197,9781,26363,825,4749,7509,8468,21551
15,Sudan,2,2016,SUD-16/HSD20/S1/P-ESNFIs/NGO/1535,4588,7648,8260,10094,30590,2080,5980,4867,6083,19010
15,Sudan,2,2016,SUD-16/HSD20/S1/P-ESNFIs/NGO/1536,1780,2220,2900,3100,10000,2112,1805,4199,3711,11827
15,Sudan,2,2016,SUD-16/HSD20/S1/H-N-WASH/INGO/1542,247484,242582,50689,49682,590437,110510,167252,88323,88282,454367
15,Sudan,2,2016,SUD-16/HSD20/S1/N/UN/1544,0,0,2040,1960,4000,0,0,2049,1956,4005
15,Sudan,2,2016,SUD-16/HSD20/S1/H-N-WASH/INGO/1546,71398,68599,14624,14050,168671,45725,48020,40297,34629,168671
15,Sudan,2,2016,SUD-16/HSD20/S1/WASH/INGO/1550,17003,21042,20286,20769,79100,17971,21466,18451,18644,76532
15,Sudan,2,2016,SUD-16/HSD20/S1/E/INGO/1552,270,380,2317,2589,5556,787,1049,4302,5520,11658
15,Sudan,2,2016,SUD-16/HSD20/S1/WASH/UN/1556,153600,230400,125440,130560,640000,153400,230200,125240,130360,639200
15,Sudan,2,2016,SUD-16/HSD20/S1/P/NGO/1558,6159,27636,8082,9123,51000,6965,29372,8746,9603,54686
15,Sudan,2,2016,SUD-16/HSD20/S1/RMS/NGO/1559,41,458,2350,2650,5499,142,630,1696,3360,5828
15,Sudan,2,2016,SUD-16/HSD20/S1/ESNFIs/NGO/1566,3000,4500,2500,2500,12500,3000,4600,2550,2700,12850
15,Sudan,2,2016,SUD-16/HSD20/S1/P/NGO/1574,12500,13000,14500,14500,54500,13159,13141,15038,15064,56402
15,Sudan,2,2016,SUD-16/HSD20/S1/WASH/INGO/1575,13859,15318,3282,4013,36472,13859,15318,3282,4013,36472
15,Sudan,1,2016,SUD-16/HSD20/R/CCS/UN/1576,2500,1600,0,0,4100,2000,1200,0,0,3200
15,Sudan,2,2016,SUD-16/HSD20/S1/WASH/INGO/1579,3385,3778,3211,3060,13434,932,905,1456,1538,4831
15,Sudan,2,2016,SUD-16/HSD20/S1/H/INGO/1580,34266,40793,42424,45688,163171,23035,27423,28519,30715,109692
15,Sudan,2,2016,SUD-16/HSD20/S1/WASH/INGO/1582,11209,20020,27293,29159,87681,10301,18399,25083,26797,80580
15,Sudan,2,2016,SUD-16/HSD20/S1/N/INGO/1584,2096,23629,6152,6000,37877,6536,29598,15224,13073,64431
15,Sudan,2,2016,SUD-16/HSD20/S1/H/NGO/1589,51131,55392,25266,27696,159485,75285,81558,37642,40779,235264
15,Sudan,2,2016,SUD-16/HSD20/S1/H/INGO/1590,47142,49065,40142,38570,174919,44314,47101,24712,31476,147603
15,Sudan,2,2016,SUD-16/HSD20/S1/E/INGO/1592,140,160,1881,2299,4480,160,143,3621,4057,7981
15,Sudan,2,2016,SUD-16/HSD20/S1/FSL/NGO/1595,13020,12500,5269,5736,36525,8067,10054,5280,5800,29201
15,Sudan,2,2016,SUD-16/HSD20/S1/N/NGO/1598,1015,915,637,663,3230,1239,1285,111,142,2777
15,Sudan,2,2016,SUD-16/HSD20/S1/WASH/UN/1602,1027,1473,0,0,2500,6476,7303,0,0,13779
15,Sudan,2,2016,SUD-16/HSD20/S1/P/NGO/1603,3788,3720,4073,3919,15500,4800,4515,3055,11600,23970
15,Sudan,2,2016,SUD-16/HSD20/S1/ESNFIs/INGO/1618,10000,15000,12500,12500,50000,8418,12629,10524,10524,42095
15,Sudan,2,2016,SUD-16/HSD20/S1/FSL/UN/1622,118200,123000,80400,80400,402000,118200,123000,80400,80400,402000
15,Sudan,2,2016,SUD-16/HSD20/S1/RMS/UN/1624,2035,3682,1938,2035,9690,2035,3682,1938,2035,9690
15,Sudan,2,2016,SUD-16/HSD20/S1/WASH/NGO/1626,7389,9998,11736,14344,43467,5233,4900,6598,5432,22163
15,Sudan,2,2016,SUD-16/HSD20/S1/ESNFIs/NGO/1630,2000,2500,2000,2000,8500,2000,2500,2000,2000,8500
15,Sudan,2,2016,SUD-16/HSD20/S1/RMS/NGO/1631,14,22,3074,3672,6782,60,15,5723,4535,10333
15,Sudan,2,2016,SUD-16/HSD20/S1/H-N/INGO/1632,76745,94463,53222,65050,289480,114035,134367,96493,97139,442034
15,Sudan,2,2016,SUD-16/HSD20/S1/WASH-N/INGO/1633,7253,20347,15794,16646,60040,9490,18890,18527,20222,67129
15,Sudan,2,2016,SUD-16/HSD20/S1/N/INGO/1635,2141,4578,3644,3644,14007,1481,8725,771,1085,12062
15,Sudan,2,2016,SUD-16/HSD20/S1/ESNFIs/UN/1636,16000,19500,22250,26750,84500,16000,19500,22250,26750,84500
15,Sudan,2,2016,SUD-16/HSD20/S1/E/NGO/1645,171,313,2300,2760,5544,202,172,2640,2622,5636
15,Sudan,2,2016,SUD-16/HSD20/S1/N-H-WASH-FSL/INGO/1646,25315,35441,20252,20253,101261,22507,32809,18265,17482,91063
15,Sudan,2,2016,SUD-16/HSD20/S1/RMS/INGO/1649,3000,6000,1400,2100,12500,698,1396,14735,13769,30598
15,Sudan,2,2016,SUD-16/HSD20/S1/ESNFIs/NGO/1660,5631,9187,6816,8002,29636,5382,8728,6458,7582,28150
15,Sudan,2,2016,SUD-16/HSD20/S1/N/NGO/1663,174,60093,18390,19528,98185,162,89358,15913,17149,122582
15,Sudan,2,2016,SUD-16/HSD20/S1/N/UN/1666,0,0,6829,6562,13391,0,0,6829,6562,13391
15,Sudan,2,2016,SUD-16/HSD20/S1/H-P/UN/1674,1500,21200,300,8000,31000,500,21040,200,7190,28930
15,Sudan,2,2016,SUD-16/HSD20/S1/RMS/UN/1675,355,6719,100,3256,10430,255,6585,65,2000,8905
15,Sudan,2,2016,SUD-16/HSD20/S1/E/INGO/1679,64,96,3081,3081,6322,87,107,6149,5012,11355
15,Sudan,2,2016,SUD-16/HSD20/S1/RMS/UN/1687,3362,10088,0,0,13450,3662,10088,0,0,13750
15,Sudan,2,2016,SUD-16/HSD20/S1/RMS/NGO/1694,2545,5468,1654,2146,11813,2545,5468,1654,2146,11813
15,Sudan,2,2016,SUD-16/HSD20/S1/N/INGO/1700,2055,9767,4463,4462,20747,3420,9981,20094,20952,54447
15,Sudan,1,2016,SUD-16/HSD20/R/CCS/UN/1705,70700,84611,97305,97384,350000,75624,90503,104081,104166,374374
15,Sudan,2,2016,SUD-16/HSD20/S1/N/NGO/1707,5331,5122,1326,1274,13053,2888,3884,14372,14840,35984
15,Sudan,2,2016,SUD-16/HSD20/S1/N/NGO/1708,1020,5680,7650,7650,22000,1537,9063,5595,5943,22138
15,Sudan,2,2016,SUD-16/HSD20/S1/P/NGO/1711,2715,17126,4891,8348,33080,2730,17142,4891,8350,33113
15,Sudan,2,2016,SUD-16/HSD20/S1/WASH/INGO/1712,57366,55072,64365,52663,229466,58366,56032,65485,53583,233466
15,Sudan,1,2016,SUD-16/HSD20/R/CCS/UN/1713,140000,120000,15000,25000,300000,120000,80000,13000,18000,231000
15,Sudan,2,2016,SUD-16/HSD20/S1/P/UN/1715,5768,13768,6600,7950,34086,7960,9707,11056,13537,42260
15,Sudan,2,2016,SUD-16/HSD20/S1/FSL/INGO/1718,93581,130783,72780,73584,370728,110136,122289,65272,72379,370076
15,Sudan,2,2016,SUD-16/HSD20/S1/RMS/NGO/1721,2075,2768,4274,5020,14137,4095,7089,7470,8539,27193
15,Sudan,2,2016,SUD-16/HSD20/S1/WASH/NGO/1726,5538,5864,8796,12379,32577,5538,5864,8796,12379,32577
15,Sudan,2,2016,SUD-16/HSD20/S1/H/INGO/1728,5860,7377,4400,5811,23448,4980,8123,4240,4891,22234
15,Sudan,2,2016,SUD-16/HSD20/S1/N/UN/1729,0,0,4200,4200,8400,0,0,4116,4284,8400
15,Sudan,2,2016,SUD-16/HSD20/S1/P/NGO/1730,523,583,1385,1345,3836,1095,929,1890,987,4901
15,Sudan,2,2016,SUD-16/HSD20/S1/H/UN/1732,101263,109701,109702,118842,439508,143000,147000,70000,75000,435000
15,Sudan,2,2016,SUD-16/HSD20/S1/H/UN/1733,119680,114986,134958,129666,499290,118950,116540,135781,130510,501781
15,Sudan,2,2016,SUD-16/HSD20/S1/FSL/INGO/1734,7802,9364,17167,17687,52020,8641,12120,14200,17710,52671
15,Sudan,2,2016,SUD-16/HSD20/S1/N/UN/1737,260,520,700,650,2130,679,1512,1604,1736,5531
15,Sudan,2,2016,SUD-16/HSD20/S1/P/UN/1741,2390,3586,9562,14342,29880,1114,1296,12673,11590,26673
15,Sudan,2,2016,SUD-16/HSD20/S1/N-H-FSL-WASH/NGO/1743,11150,21970,33400,37239,103759,9812,21311,25718,32398,89239
15,Sudan,2,2016,SUD-16/HSD20/S1/N/NGO/1744,500,2264,4784,4784,12332,220,430,300,600,1550
15,Sudan,2,2016,SUD-16/HSD20/S1/WASH/UN/1746,29403,30597,44100,45900,150000,97723,101685,146585,152537,498530
15,Sudan,2,2016,SUD-16/HSD20/S1/E/UN/1748,0,0,27000,27000,54000,0,0,30720,30720,61440
15,Sudan,1,2016,SUD-16/HSD20/RE/N/UN/1754,0,0,750,750,1500,0,0,794,906,1700
15,Sudan,2,2016,SUD-16/HSD20/S1/RMS/UN/1760,4935,5135,7402,7702,25174,14605,15597,21950,22348,74500
15,Sudan,2,2016,SUD-16/HSD20/S1/P-N-WASH-E-ESNFIs-H-RMS/NGO/1764,12477,23548,20308,27947,84280,13676,27608,24560,31370,97214
15,Sudan,2,2016,SUD-16/HSD20/S1/ESNFIs/NGO/1776,5965,17895,2983,2983,29826,2087,6263,1044,1044,10438
15,Sudan,2,2016,SUD-16/HSD20/S1/P/UN/1777,5630,13120,32500,42500,93750,5630,13120,32500,42500,93750
15,Sudan,2,2016,SUD-16/HSD20/S1/H/NGO/1779,9128,13923,12005,12963,48019,7845,14762,8868,9971,41446
15,Sudan,1,2016,SUD-16/HSD20/RE/WASH/UN/1780,27032,29278,10892,8742,75944,26980,29150,11010,8615,75755
15,Sudan,1,2016,SUD-16/HSD20/RE/RMS/UN/1781,12472,12472,0,0,24944,12472,12472,0,0,24944
15,Sudan,1,2016,SUD-16/HSD20/RE/RMS/INGO/1782,2142,6854,2856,2428,14280,1520,4867,2028,1724,10139
15,Sudan,1,2016,SUD-16/HSD20/RE/RMS/INGO/1783,3742,11973,4989,4240,24944,21200,29227,0,0,50427
15,Sudan,1,2016,SUD-16/HSD20/RE/RMS/UN/1786,2223,2610,9049,11062,24944,3742,11973,4989,4240,24944
15,Sudan,1,2016,SUD-16/HSD20/RE/WASH/INGO/1787,4291,13725,5719,4860,28595,4291,13725,5719,4860,28595
15,Sudan,1,2016,SUD-16/HSD20/RE/WASH/UN/3189,1515,1779,6167,7539,17000,1337,1570,5441,6652,15000
15,Sudan,1,2016,SUD-16/HSD20/RE/RMS/INGO/3191,872,1306,1307,1961,5446,1524,2134,792,1648,6098
15,Sudan,1,2016,SUD-16/HSD20/RE/RMS/INGO/3193,4397,5893,1329,1381,13000,1736,5843,2552,2568,12699
15,Sudan,1,2016,SUD-16/HSD20/RE/RMS/NGO/3195,569,2655,266,305,3795,569,2655,266,305,3795
15,Sudan,1,2016,SUD-16/HSD20/RE/RMS/NGO/3202,1113,1668,2594,3890,9265,1150,1700,2600,3900,9350
15,Sudan,1,2016,SUD-16/HSD20/RE/RMS/INGO/3204,3259,4889,668,1001,9817,3114,4670,1364,2046,11194
15,Sudan,1,2016,SUD-16/HSD20/RE/RMS/UN/3213,3861,3862,0,0,7723,5000,5112,0,0,10112
15,Sudan,2,2016,SUD-16/HSD20/S1/P/INGO/3276,30,30,0,0,60,26,30,0,0,56
15,Sudan,1,2016,SUD-16/HSD20/RE/P/UN/3432,0,0,3787,5681,9468,0,0,5390,3680,9070
15,Sudan,1,2016,SUD-16/HSD20/RE/P/NGO/3670,1142,2456,845,1267,5710,2019,5167,618,814,8618
15,Sudan,1,2016,SUD-16/HSD20/RE/RMS/UN/4103,2000,8000,0,0,10000,2372,9486,0,0,11858
15,Sudan,1,2016,SUD-16/HSD20/RE/ESNFIs/INGO/4121,1489,3475,1986,2978,9928,1489,3475,1986,2978,9928
15,Sudan,1,2016,SUD-16/HSD20/RE/RMS/NGO/4143,1440,2160,3700,3700,11000,1500,2500,3800,3750,11550
15,Sudan,1,2016,SUD-16/HSD20/RE/RMS/INGO/4147,1780,5299,2920,5501,15500,772,1874,937,1930,5513
15,Sudan,1,2016,SUD-16/HSD20/RE/H/UN/4150,1882,1958,2122,2038,8000,1800,2040,2140,2120,8100
15,Sudan,1,2016,SUD-16/HSD20/RE/RMS/INGO/4151,2650,2550,2448,2352,10000,4578,7421,7470,7973,27442
15,Sudan,1,2016,SUD-16/HSD20/RE/RMS/UN/4152,80,2720,30,1230,4060,0,2716,0,1139,3855
15,Sudan,1,2016,SUD-16/HSD20/RE/RMS/UN/4154,7500,7500,0,0,15000,7809,8461,0,0,16270
15,Sudan,1,2016,SUD-16/HSD20/RE/N/UN/4237,0,0,2500,2500,5000,0,0,2922,3041,5963
15,Sudan,1,2016,SUD-16/HSD20/RE/H/UN/4299,1971854,2061484,2599262,2330373,8962973,2255790,2455600,2774322,2646245,10131957
15,Sudan,1,2016,SUD-16/HSD20/RE/H/UN/4314,490,470,530,510,2000,498,468,576,518,2060
15,Sudan,1,2016,SUD-16/HSD20/RE/WASH/UN/4330,5311,7009,4460,4460,21240,6622,8742,5563,5563,26490
15,Sudan,1,2016,SUD-16/HSD20/RE/WASH/UN/4332,208206,200040,216703,208207,833156,206318,198416,205938,207245,817917
15,Sudan,1,2016,SUD-16/HSD20/RE/WASH/UN/4333,145901,151815,218851,227738,744305,291602,279834,173945,189291,934672
15,Sudan,2,2017,SUD-17/HSD20/S1/RCF/UN/4731,585,7435,470,2550,11040,314,8343,77,2320,11054
15,Sudan,2,2017,SUD-17/HSD20/S1/P/UN/4739,560,9000,500,1000,11060,560,9300,500,1200,11560
15,Sudan,1,2017,SUD-17/HSD20/R/CCS/UN/4740,40425,50225,78400,75950,245000,34660,46488,67405,67722,216275
15,Sudan,1,2017,SUD-17/HSD20/R/CCS/UN/4741,0,1,0,0,1,0,1,0,0,1
15,Sudan,1,2017,SUD-17/HSD20/R/CCS/UN/4742,0,1,0,0,1,0,1,0,0,1
15,Sudan,1,2017,SUD-17/HSD20/R/CCS/UN/4743,256846,267329,56381,58682,639238,256846,267329,56381,58682,639238
15,Sudan,1,2017,SUD-17/HSD20/R/CCS/UN/4744,108131,112545,46342,48234,315252,0,0,0,0,0
15,Sudan,1,2017,SUD-17/HSD20/R/CCS/UN/4746,439230,536835,658792,805253,2440110,439230,536835,658792,805253,2440110
15,Sudan,2,2017,SUD-17/HSD20/S1/ESNFIs/NGO/4750,2150,2650,2200,2555,9555,2150,2650,2200,2555,9555
15,Sudan,2,2017,SUD-17/HSD20/S1/RRR/NGO/4751,300,450,300,450,1500,300,450,300,450,1500
15,Sudan,2,2017,SUD-17/HSD20/S1/WASH/INGO/4753,22543,24422,17526,18986,83477,15374,17586,10890,16938,60788
15,Sudan,2,2017,SUD-17/HSD20/S1/H/INGO/4754,120935,118540,24770,24279,288524,40642,81330,52334,46063,220369
15,Sudan,2,2017,SUD-17/HSD20/S1/WASH/INGO/4755,21720,25990,21991,22299,92000,21796,26985,21538,21681,92000
15,Sudan,2,2017,SUD-17/HSD20/S1/N/INGO/4758,1616,3355,15191,14704,34866,916,1567,24850,26785,54118
15,Sudan,2,2017,SUD-17/HSD20/S1/H/UN/4759,3200,19273,2200,4546,29219,2800,19800,2000,4460,29060
15,Sudan,2,2017,SUD-17/HSD20/S1/N-WASH/INGO/4760,9597,13045,11183,12458,46283,17484,21756,14291,15474,69005
15,Sudan,2,2017,SUD-17/HSD20/S1/N/INGO/4765,0,1009,4713,5533,11255,967,14979,4086,4525,24557
15,Sudan,2,2017,SUD-17/HSD20/S1/H/INGO/4775,30957,33250,24719,25728,114654,37577,50605,25121,12831,126134
15,Sudan,2,2017,SUD-17/HSD20/S1/RCF/INGO/4782,820,1230,1246,1898,5194,1524,2134,792,1648,6098
15,Sudan,2,2017,SUD-17/HSD20/S1/FSL/INGO/4783,33405,36189,14316,15510,99420,35965,38092,14808,16925,105790
15,Sudan,2,2017,SUD-17/HSD20/S1/RRR/INGO/4785,2845,4917,2586,2587,12935,5304,9167,4821,4823,24115
15,Sudan,2,2017,SUD-17/HSD20/S1/H-N/INGO/4788,6398,8793,3147,3410,21748,4111,9289,5839,6779,26018
15,Sudan,2,2017,SUD-17/HSD20/S1/FSL/UN/4789,3,2,3,3,11,3,2,3,3,11
15,Sudan,2,2017,SUD-17/HSD20/S1/H/INGO/4792,56316,68377,55832,64158,244683,50383,55651,26743,34286,167063
15,Sudan,2,2017,SUD-17/HSD20/S1/ESNFIs/UN/4796,14000,21000,0,0,35000,8647,17288,0,0,25935
15,Sudan,2,2017,SUD-17/HSD20/S1/N/UN/4799,85,88,0,0,173,105,330,0,0,435
15,Sudan,2,2017,SUD-17/HSD20/S1/RCF/UN/4801,1901,5805,1825,1825,11356,2685,3506,4233,4167,14591
15,Sudan,2,2017,SUD-17/HSD20/S1/N/NGO/4803,48,10089,1016,1017,12170,86,13291,1203,1562,16142
15,Sudan,2,2017,SUD-17/HSD20/S1/H/INGO/4804,28290,61264,15994,16304,121852,27789,62983,16943,13934,121649
15,Sudan,2,2017,SUD-17/HSD20/S1/N/INGO/4805,2334,9326,2879,3336,17875,9155,26639,1294,1444,38532
15,Sudan,2,2017,SUD-17/HSD20/S1/WASH/INGO/4807,6240,6994,9360,9906,32500,6398,7549,9548,11388,34883
15,Sudan,2,2017,SUD-17/HSD20/S1/RRR/INGO/4820,6516,6807,8990,9321,31634,2331,2575,3852,3842,12600
15,Sudan,2,2017,SUD-17/HSD20/S1/ESNFIs/INGO/4822,850,1912,2697,3041,8500,0,0,0,0,0
15,Sudan,2,2017,SUD-17/HSD20/S1/RCF/INGO/4827,10010,18200,8190,9100,45500,11108,20196,9088,10098,50490
15,Sudan,2,2017,SUD-17/HSD20/S1/WASH/INGO/4830,6750,11700,12600,13950,45000,7965,13807,14869,16462,53103
15,Sudan,2,2017,SUD-17/HSD20/S1/RRR/UN/4840,1710,3150,2740,1900,9500,1700,2700,2989,1890,9279
15,Sudan,2,2017,SUD-17/HSD20/S1/H/NGO/4841,5066,7601,8031,8524,29222,8463,11321,8078,5401,33263
15,Sudan,2,2017,SUD-17/HSD20/S1/WASH/INGO/4844,4007,4208,5995,6194,20404,4454,4676,8057,8451,25638
15,Sudan,2,2017,SUD-17/HSD20/S1/P/NGO/4847,10220,11020,10500,10500,42240,6163,4245,5339,4390,20137
15,Sudan,2,2017,SUD-17/HSD20/S1/FSL/INGO/4848,34274,44335,25401,31424,135434,34216,44368,25333,31323,135240
15,Sudan,2,2017,SUD-17/HSD20/S1/E-P/INGO/4849,157,148,6343,6552,13200,253,143,6605,6713,13714
15,Sudan,2,2017,SUD-17/HSD20/S1/ESNFIs/UN/4858,2730,4030,3640,2600,13000,3435,3088,3977,5284,15784
15,Sudan,2,2017,SUD-17/HSD20/S1/ESNFIs/INGO/4863,3790,5686,4737,4737,18950,5371,8056,6714,6714,26855
15,Sudan,2,2017,SUD-17/HSD20/S1/N/UN/4867,0,0,5706,5483,11189,0,0,5706,5483,11189
15,Sudan,2,2017,SUD-17/HSD20/S1/E/NGO/4871,45,45,1650,1650,3390,56,63,3112,3495,6726
15,Sudan,2,2017,SUD-17/HSD20/S1/H/UN/4876,39752,42973,36431,50844,170000,44423,55221,32632,40824,173100
15,Sudan,2,2017,SUD-17/HSD20/S1/P/NGO/4877,3163,6571,2520,4720,16974,4150,6603,2300,4340,17393
15,Sudan,2,2017,SUD-17/HSD20/S1/N-E/INGO/4888,7208,9515,10552,12896,40171,0,11079,19657,16083,46819
15,Sudan,2,2017,SUD-17/HSD20/S1/E-P/UN/4893,176,199,5031,4860,10266,35,33,4075,3914,8057
15,Sudan,2,2017,SUD-17/HSD20/S1/N/NGO/4900,3130,3530,2940,3060,12660,1502,6388,17194,19478,44562
15,Sudan,2,2017,SUD-17/HSD20/S1/RRR/INGO/4910,5938,8907,0,0,14845,5938,8907,0,0,14845
15,Sudan,2,2017,SUD-17/HSD20/S1/WASH/INGO/4913,25374,24891,5091,4893,60249,25374,24891,5091,4893,60249
15,Sudan,2,2017,SUD-17/HSD20/S1/N/INGO/4915,415,8310,3330,3466,15521,420,14155,3178,3607,21360
15,Sudan,2,2017,SUD-17/HSD20/S1/RCF/NGO/4921,11755,15257,4562,4748,36322,20360,24018,12571,15092,72041
15,Sudan,2,2017,SUD-17/HSD20/S1/WASH/INGO/4923,4929,6506,3726,4554,19715,6639,8763,5577,5577,26556
15,Sudan,2,2017,SUD-17/HSD20/S1/RCF/INGO/4928,3692,3615,752,741,8800,3692,3615,752,741,8800
15,Sudan,2,2017,SUD-17/HSD20/S1/E-P/INGO/4930,173,133,3612,3228,7146,403,161,3181,3454,7199
15,Sudan,2,2017,SUD-17/HSD20/S1/N-WASH/INGO/4934,1900,3643,8335,7647,21525,2122,13503,12317,12986,40928
15,Sudan,2,2017,SUD-17/HSD20/S1/WASH/INGO/4935,10983,9937,14664,16736,52320,4578,4142,6104,6976,21800
15,Sudan,1,2017,SUD-17/HSD20/RE/WASH/INGO/6245,6300,6560,1300,1340,15500,7208,9553,1272,1687,19720
15,Sudan,1,2017,SUD-17/HSD20/R/RRR/INGO/6246,8842,9214,1942,2022,22020,216,1315,432,530,2493
15,Sudan,1,2017,SUD-17/HSD20/R/H/NGO/6247,8000,16000,14400,21600,60000,1168,13671,7671,7536,30046
15,Sudan,1,2017,SUD-17/HSD20/R/H-N-WASH/INGO/6249,68599,71398,14050,14624,168671,41174,53751,26164,27232,148321
15,Sudan,1,2017,SUD-17/HSD20/RE/H-RCF/INGO/6254,4034,4194,4729,4927,17884,3086,5299,3342,4262,15989
15,Sudan,1,2017,SUD-17/HSD20/RE/WASH-RCF/INGO/6255,2520,5880,6174,6426,21000,4039,9426,9901,10304,33670
15,Sudan,1,2017,SUD-17/HSD20/RE/ESNFIs-RCF/NGO/6256,2600,4700,3800,4254,15354,2600,4700,3800,4254,15354
15,Sudan,1,2017,SUD-17/HSD20/R/WASH/INGO/6296,4960,5165,6063,6312,22500,4750,4942,5804,6040,21536
15,Sudan,1,2017,SUD-17/HSD20/RE/H-N-WASH/INGO/6395,8292,9213,2534,2994,23033,25524,6616,8599,20048,60787
15,Sudan,1,2017,SUD-17/HSD20/RE/ESNFIs-P/NGO/6396,500,2000,1400,2100,6000,1436,2750,1640,2360,8186
15,Sudan,1,2017,SUD-17/HSD20/RE/H-WASH/UN/6415,3920,4079,5881,6120,20000,13300,14000,20300,22400,70000
15,Sudan,1,2017,SUD-17/HSD20/RE/H-WASH/UN/6416,44627,56278,41790,52560,195255,44566,56100,41650,52470,194786
15,Sudan,1,2017,SUD-17/HSD20/RE/P/INGO/6532,1850,2150,2393,2045,8438,320,320,1447,1340,3427
15,Sudan,1,2017,SUD-17/HSD20/R2/WASH/INGO/6887,10680,18690,12015,12015,53400,11042,15082,12100,16146,54370
15,Sudan,1,2017,SUD-17/HSD20/R2/WASH/INGO/6895,24345,25335,35029,36460,121169,9377,9865,13611,14080,46933
15,Sudan,1,2017,SUD-17/HSD20/R2/H/NGO/6913,10442,15552,4182,4755,34931,2514,1786,1033,2577,7910
15,Sudan,1,2017,SUD-17/HSD20/R2/H/NGO/6921,19811,19504,10055,10255,59625,3466,4227,2329,2579,12601
15,Sudan,1,2017,SUD-17/HSD20/R2/P/UN/6931,5524,6870,8359,7872,28625,3314,4122,5015,4723,17174
15,Sudan,1,2017,SUD-17/HSD20/R2/FSL/INGO/6933,21199,49022,25173,37098,132492,9727,22493,11550,17022,60792
15,Sudan,1,2017,SUD-17/HSD20/R2/P/NGO/6952,8210,9010,6500,6500,30220,12655,14137,7305,8333,42430
15,Sudan,1,2017,SUD-17/HSD20/R2/FSL/INGO/6955,34806,36224,50085,52128,173243,188,337,20,30,575
15,Sudan,1,2017,SUD-17/HSD20/R2/H/NGO/6971,27429,41903,16463,21070,106865,133,280,162,215,790
15,Sudan,1,2017,SUD-17/HSD20/R2/CCS/UN/6972,2700,2700,0,0,5400,3323,3323,0,0,6646
15,Sudan,1,2017,SUD-17/HSD20/R2/WASH/INGO/6978,10920,16380,3640,5460,36400,11060,16589,3686,5530,36865
15,Sudan,1,2017,SUD-17/HSD20/RE/RCF/UN/7285,2100,15400,0,0,17500,8225,9275,0,0,17500
15,Sudan,1,2017,SUD-17/HSD20/R/P/NGO/7309,500,1000,3000,3000,7500,103,359,1809,1812,4083
15,Sudan,1,2017,SUD-17/HSD20/R/H/INGO/7334,1224,1326,1176,1274,5000,598,975,623,1014,3210
15,Sudan,1,2017,SUD-17/HSD20/R/WASH-FSL-E/INGO/7336,5581,5860,8093,8373,27907,630,1424,0,0,2054
15,Sudan,1,2017,SUD-17/HSD20/R/FSL/UN/7337,3710,4385,4216,4554,16865,71,141,146,144,502
15,Sudan,1,2017,SUD-17/HSD20/RE/WASH/INGO/7622,14091,15890,4796,5197,39974,720,780,240,260,2000
15,Sudan,2,2018,SUD-18/HSD20/SA1/WASH-H/INGO/7718,22203,24053,21332,23110,90698,11859,12778,10988,11850,47475
15,Sudan,2,2018,SUD-18/HSD20/SA1/RCF/NGO/7723,834,1038,741,1017,3630,0,0,0,0,0
15,Sudan,2,2018,SUD-18/HSD20/SA1/RCF/INGO/7726,5466,6958,6760,9828,29012,497,1039,220,229,1985
15,Sudan,2,2018,SUD-18/HSD20/SA1/H-WASH/INGO/7734,52925,79388,14885,18193,165391,19826,21739,5458,8294,55317
15,Sudan,2,2018,SUD-18/HSD20/SA2/RCF/INGO/7791,4286,6429,4286,6430,21431,11357,16480,12280,13173,53290
15,Sudan,2,2018,SUD-18/HSD20/SA2/WASH/INGO/7796,3951,9219,9548,10208,32926,332,535,0,0,867
15,Sudan,2,2018,SUD-18/HSD20/SA2/E/NGO/7803,72,38,1308,1351,2769,206,66,149,158,579
15,Sudan,2,2018,SUD-18/HSD20/SA2/RCF/INGO/7805,7827,7827,6404,9566,31624,4054,6258,0,0,10312
15,Sudan,2,2018,SUD-18/HSD20/SA2/WASH/INGO/7807,9387,10204,9796,11428,40815,0,0,0,0,0
15,Sudan,2,2018,SUD-18/HSD20/SA2/FSL/INGO/7820,6400,6000,3922,3678,20000,6400,6000,3922,3678,20000
15,Sudan,2,2018,SUD-18/HSD20/SA2/WASH/INGO/7822,25374,24891,5091,4893,60249,9669,11946,1950,2650,26215
15,Sudan,2,2018,SUD-18/HSD20/SA2/RCF/INGO/7823,14497,14030,6185,5863,40575,6438,8501,3799,3632,22370
15,Sudan,2,2018,SUD-18/HSD20/SA2/WASH/INGO/7824,19318,21351,30503,30503,101675,0,0,0,0,0
15,Sudan,2,2018,SUD-18/HSD20/SA2/FSL/INGO/7830,6539,9031,0,0,15570,300,312,0,0,612
15,Sudan,2,2018,SUD-18/HSD20/SA2/FSL/INGO/7865,1423,1579,2220,2278,7500,1420,1570,2213,2272,7475
15,Sudan,2,2018,SUD-18/HSD20/SA2/WASH/INGO/7951,6328,7172,5383,5653,24536,6328,7172,5383,5653,24536
15,Sudan,2,2018,SUD-18/HSD20/SA2/N-H/NGO/8055,42,10408,980,1470,12900,23,2490,273,322,3108
15,Sudan,2,2018,SUD-18/HSD20/SA2/RCF/INGO/8199,2100,2400,600,900,6000,576,644,171,239,1630
15,Sudan,2,2018,SUD-18/HSD20/SA2/RRR/NGO/8208,700,1080,410,490,2680,200,331,198,219,948
15,Sudan,2,2018,SUD-18/HSD20/SA2/RCF/NGO/8217,129,161,1681,1826,3797,43,35,97,72,247
15,Sudan,2,2018,SUD-18/HSD20/SA2/N/UN/8225,0,0,8290,8289,16579,0,0,5615,6082,11697
15,Sudan,2,2018,SUD-18/HSD20/SA2/FSL/INGO/8803,7428,7731,1521,1584,18264,2197,2285,450,468,5400
15,Sudan,2,2018,SUD-18/HSD20/SA2/P/NGO/8884,1546,3540,350,1050,6486,35,582,98,228,943
15,Sudan,1,2018,SUD-18/HSD20/RE/WASH/INGO/9226,7261,7804,5672,5799,26536,7261,7804,5672,5799,26536
62,Syria,2,2015,SYR-15/DDA-3477/WCP/WASH/UN/2047,185220,192780,161000,161000,700000,185220,192780,161000,161000,700000
62,Syria,2,2015,SYR-15/DDA-3477/WCP/WASH/UN/2048,11032,11032,8967,8967,39998,11032,11032,8967,8967,39998
62,Syria,2,2015,SYR-15/DDA-3477/WCP/WASH/INGO/2049,100586,104692,54162,56371,315811,100586,104692,54162,56371,315811
62,Syria,2,2015,SYR-15/DDA-3477/WCP/WASH/INGO/2079,97650,146475,39874,41501,325500,100112,150170,40880,42548,333710
62,Syria,1,2015,SYR-15/DDA-3477/RA/WASH/UN/2161,335160,348840,258000,258000,1200000,558600,581400,430000,430000,2000000
62,Syria,1,2015,SYR-15/DDA-3558/RA/FSA/INGO/2213,2072,2533,2432,2973,10010,2072,2533,2432,2973,10010
62,Syria,2,2015,SYR-15/DDA-3558/SA/S/NFI/NGO/2314,540,840,755,756,2891,385,600,540,540,2065
62,Syria,1,2016,SYR-16/DDA-3558/RA/H/UN/2327,2809,2699,136,130,5774,3162,3038,153,147,6500
62,Syria,1,2015,SYR-15/DDA-3558/RA/H/NGO/2331,3650,2850,0,1400,7900,8003,7728,3890,3625,23246
62,Syria,1,2015,SYR-15/DDA-3558/RA/LOG/UN/2333,1,1,1,1,4,0,0,0,0,0
62,Syria,1,2015,SYR-15/DDA-3558/RA/FSA/O/2335,36296,61869,45421,36896,180482,35296,60869,44421,35896,176482
62,Syria,1,2015,SYR-15/DDA-3558/RA/LOG/UN/2341,0,0,0,0,0,0,0,0,0,0
62,Syria,1,2016,SYR-16/DDA-3558/RA/S/NFI/NGO/2343,2361,2602,1920,2113,8996,2361,2602,1920,2113,8996
62,Syria,2,2016,SYR-16/DDA-3558/SA/FSA-S/NFI/UN/2355,8668,10040,5345,5152,29205,7515,8934,4520,4368,25337
62,Syria,2,2016,SYR-16/DDA-3558/SA/WASH/INGO/2403,49017,73526,19607,21241,163391,105309,157963,42123,45634,351029
62,Syria,1,2016,SYR-16/DDA-3558/RA/S/NFI/NGO/2405,150,250,300,300,1000,150,265,310,325,1050
62,Syria,2,2016,SYR-16/DDA-3558/SA/S/NFI-FSA/NGO/2406,22458,26127,38290,56125,143000,31232,30702,69085,81151,212170
62,Syria,2,2016,SYR-16/DDA-3558/SA/H/NGO/2447,240,296,0,0,536,309,227,2,1,539
62,Syria,2,2016,SYR-16/DDA-3558/SA/E/NGO/2449,0,0,4250,4250,8500,0,0,14545,12772,27317
62,Syria,2,2016,SYR-16/DDA-3558/SA/E/INGO/2457,150,150,6150,6150,12600,71,235,7175,7589,15070
62,Syria,2,2016,SYR-16/DDA-3558/SA/FSA/UN/2464,75075,78925,95550,100450,350000,146301,153804,186201,195750,682056
62,Syria,2,2016,SYR-16/DDA-3558/SA/FSA/NGO/2476,9200,24750,13550,30500,78000,6500,12400,8150,16100,43150
62,Syria,2,2016,SYR-16/DDA-3558/SA/H/NGO/2499,5900,5900,4100,4100,20000,8254,11838,4896,4927,29915
62,Syria,2,2016,SYR-16/DDA-3558/SA/FSA/NGO/2501,700,950,1420,1550,4620,763,1059,1518,1612,4952
62,Syria,2,2016,SYR-16/DDA-3558/SA/WASH/INGO/2506,37500,37000,25200,25300,125000,134983,140493,82645,101008,459129
62,Syria,2,2016,SYR-16/DDA-3558/SA/FSA/INGO/2512,42570,70950,85140,85140,283800,61129,92358,45249,45241,243977
62,Syria,2,2016,SYR-16/DDA-3558/SA/N/UN/2515,0,9400,35950,35950,81300,0,26740,59130,59130,145000
62,Syria,2,2016,SYR-16/DDA-3558/SA/H/NGO/2516,321,284,0,0,605,338,259,8,8,613
62,Syria,2,2016,SYR-16/DDA-3558/SA/H/UN/2521,15000,35000,15000,15000,80000,53715,75676,12017,12063,153471
62,Syria,2,2016,SYR-16/DDA-3558/SA/FSA/UN/2525,6525,6975,4500,4500,22500,6762,7228,4663,4663,23316
62,Syria,1,2016,SYR-16/DDA-3558/RA/WASH/INGO/2552,11000,16000,9000,9000,45000,11000,16000,9000,9000,45000
62,Syria,1,2016,SYR-16/DDA-3558/RA/H/NGO/2561,450,450,245,245,1390,550,758,329,211,1848
62,Syria,1,2016,SYR-16/DDA-3558/RA/H/NGO/2562,724,623,317,251,1915,593,853,535,379,2360
62,Syria,1,2016,SYR-16/DDA-3558/RA/H/NGO/2563,235,1135,160,160,1690,217,1247,166,216,1846
62,Syria,1,2016,SYR-16/DDA-3558/RA/H/UN/2574,123960,123960,82640,82640,413200,124088,134410,73826,78402,410726
62,Syria,1,2016,SYR-16/DDA-3558/RA/S/NFI/NGO/2788,392,589,560,694,2235,217,326,368,449,1360
62,Syria,1,2016,SYR-16/DDA-3558/RA/FSA/O/2936,5334,11579,8209,8210,33332,5334,11579,8209,8210,33332
62,Syria,1,2016,SYR-16/DDA-3558/RA/H/NGO/3137,616,518,243,243,1620,751,565,216,91,1623
62,Syria,1,2016,SYR-16/DDA-3558/RA/S/NFI/NGO/3147,133,156,296,337,922,133,158,299,340,930
62,Syria,1,2016,SYR-16/DDA-3558/RA/FSA/UN/3151,20880,22320,14400,14400,72000,20793,22227,14340,14340,71700
62,Syria,1,2016,SYR-16/DDA-3558/RA/FSA/NGO/3424,8699,8493,4726,4614,26532,8855,8785,4821,4692,27153
62,Syria,1,2016,SYR-16/DDA-3558/RA/WASH/INGO/3715,23750,23750,23750,23750,95000,23750,23750,23750,23750,95000
62,Syria,1,2016,SYR-16/DDA-3558/RA/S/NFI/NGO/3804,300,400,500,550,1750,298,408,507,576,1789
62,Syria,1,2016,SYR-16/DDA-3558/RA/H/NGO/3814,600,900,750,750,3000,954,1895,576,658,4083
62,Syria,2,2016,SYR-16/DDA-3558/SA/E/INGO/4158,785,1232,9841,9150,21008,973,1326,10316,8891,21506
62,Syria,2,2016,SYR-16/DDA-3558/SA/WASH/INGO/4161,88968,139039,42258,45779,316044,123579,186469,53646,57841,421535
62,Syria,2,2016,SYR-16/DDA-3558/SA/S/NFI-WASH/INGO/4164,8291,9346,4869,5494,28000,9170,10546,5319,6049,31084
62,Syria,2,2016,SYR-16/DDA-3558/SA/E-WASH/INGO/4178,7200,9000,5400,5400,27000,7200,9000,5400,5400,27000
62,Syria,2,2016,SYR-16/DDA-3558/SA/H/UN/4180,20733,20735,8886,8886,59240,0,0,0,0,0
62,Syria,2,2016,SYR-16/DDA-3558/SA/H/NGO/4187,81813,86152,23724,23645,215334,81813,86152,23724,23645,215334
62,Syria,2,2016,SYR-16/DDA-3558/SA/FSA/NGO/4196,330,677,646,681,2334,690,932,715,698,3035
62,Syria,2,2016,SYR-16/DDA-3558/SA/H/NGO/4202,1200,1200,435,435,3270,485,635,180,164,1464
62,Syria,2,2016,SYR-16/DDA-3558/SA/WASH/INGO/4206,51750,63250,0,0,115000,33668,46968,27204,27204,135044
62,Syria,2,2016,SYR-16/DDA-3558/SA/N/UN/4210,0,0,24610,25870,50480,0,0,24610,25870,50480
62,Syria,2,2016,SYR-16/DDA-3558/SA/N/UN/4215,0,0,145000,145000,290000,0,0,165500,165500,331000
62,Syria,2,2016,SYR-16/DDA-3558/SA/H/NGO/4216,270,186,2,1,459,330,165,3,13,511
62,Syria,2,2016,SYR-16/DDA-3558/SA/S/NFI/NGO/4224,0,0,2626,2996,5622,0,0,3298,3342,6640
62,Syria,2,2016,SYR-16/DDA-3558/SA/H/NGO/4228,222,468,222,432,1344,357,568,335,262,1522
62,Syria,2,2016,SYR-16/DDA-3558/SA/S/NFI/UN/4262,0,0,7651,7651,15302,0,0,7651,7651,15302
62,Syria,2,2016,SYR-16/DDA-3558/SA/FSA/NGO/4279,3000,3850,5150,6000,18000,2828,3629,4854,5655,16966
62,Syria,2,2016,SYR-16/DDA-3558/SA/FSA-S/NFI/UN/4281,616,772,584,558,2530,567,723,534,515,2339
62,Syria,2,2016,SYR-16/DDA-3558/SA/FSA/INGO/4282,13468,34688,22176,22168,92500,3000,7912,5206,5179,21297
62,Syria,2,2016,SYR-16/DDA-3558/SA/FSA-P/INGO/4287,815,918,1024,1203,3960,815,918,1024,1203,3960
62,Syria,2,2016,SYR-16/DDA-3558/SA/S/NFI/NGO/4288,0,0,3600,3600,7200,0,0,3600,3600,7200
62,Syria,2,2016,SYR-16/DDA-3558/SA/E/INGO/4290,100,200,6900,6900,14100,67,248,5554,6557,12426
62,Syria,2,2016,SYR-16/DDA-3558/SA/E/NGO/4291,125,1400,3700,3700,8925,150,1450,3529,3918,9047
62,Syria,2,2016,SYR-16/DDA-3558/SA/WASH/NGO/4292,300,500,1030,1250,3080,290,477,1004,1225,2996
62,Syria,2,2016,SYR-16/DDA-3558/SA/S/NFI-WASH-P/INGO/4293,120,300,350,350,1120,289,332,163,153,937
62,Syria,2,2016,SYR-16/DDA-3558/SA/P/INGO/4294,8010,9010,3300,3750,24070,10410,10014,8884,6042,35350
62,Syria,2,2016,SYR-16/DDA-3558/SA/H/NGO/4295,249,217,0,0,466,288,259,0,0,547
62,Syria,2,2016,SYR-16/DDA-3558/SA/H/NGO/4298,300,1200,240,300,2040,261,1062,192,277,1792
62,Syria,2,2016,SYR-16/DDA-3558/SA/FSA-WASH-S/NFI/INGO/4301,102900,107100,68600,71400,350000,110936,115471,75738,79437,381582
62,Syria,2,2016,SYR-16/DDA-3558/SA/S/NFI-P/INGO/4304,196,179,315,360,1050,196,179,315,360,1050
62,Syria,2,2016,SYR-16/DDA-3558/SA/WASH/INGO/4305,73500,76500,40000,60000,250000,84061,89859,55075,60872,289867
62,Syria,2,2016,SYR-16/DDA-3558/SA/S/NFI/NGO/4306,352,374,467,608,1801,352,374,467,608,1801
62,Syria,2,2016,SYR-16/DDA-3558/SA/P-H-WASH/UN/4307,140,175679,210,34481,210510,416,157722,2152,29818,190108
62,Syria,2,2016,SYR-16/DDA-3558/SA/P/INGO/4311,246,247,1018,1018,2529,240,307,1476,2060,4083
62,Syria,1,2016,SYR-16/DDA-3558/RA/LOG/UN/4361,1,0,0,0,1,1,0,0,0,1
62,Syria,2,2017,SYR-17/DDA-3558/Aleppo SA 2017/FSA/NGO/4519,2780,3075,2198,2301,10354,2780,3075,2198,2301,10354
62,Syria,2,2017,SYR-17/DDA-3558/Aleppo SA 2017/S/NFI/NGO/4531,5000,9000,12000,16120,42120,6732,13305,17262,19978,57277
62,Syria,2,2017,SYR-17/DDA-3558/Aleppo SA 2017/S/NFI/NGO/4532,200,200,300,300,1000,343,345,141,125,954
62,Syria,2,2017,SYR-17/DDA-3558/Aleppo SA 2017/E/INGO/4551,65,181,7444,1221,8911,65,181,7444,1222,8912
62,Syria,2,2017,SYR-17/DDA-3558/Aleppo SA 2017/WASH-S/NFI/INGO/4566,16800,25200,6720,7280,56000,0,0,3697,2124,5821
62,Syria,2,2017,SYR-17/DDA-3558/Aleppo SA 2017/E/INGO/4585,200,400,2662,2650,5912,102,687,5002,7841,13632
62,Syria,2,2017,SYR-17/DDA-3558/Aleppo SA 2017/WASH/INGO/4595,32075,42341,23095,30792,128303,32835,43342,23641,31522,131340
62,Syria,2,2017,SYR-17/DDA-3558/Aleppo SA 2017/WASH/INGO/4596,26550,27900,19170,16380,90000,23359,24164,15304,17720,80547
62,Syria,2,2017,SYR-17/DDA-3558/Aleppo SA 2017/H-N/INGO/4614,8361,8932,1429,1373,20095,0,0,0,0,0
62,Syria,2,2017,SYR-17/DDA-3558/Aleppo SA 2017/S/NFI/INGO/4623,300,353,491,491,1635,0,0,0,0,0
62,Syria,2,2017,SYR-17/DDA-3558/Aleppo SA 2017/E-P/INGO/4634,148,346,1559,1901,3954,123,328,1855,2510,4816
62,Syria,2,2017,SYR-17/DDA-3558/Aleppo SA 2017/H-WASH-P/UN/4643,12000,119000,17000,30500,178500,10727,174989,7800,27700,221216
62,Syria,2,2017,SYR-17/DDA-3558/Aleppo SA 2017/E-P/INGO/4647,0,0,930,3425,4355,28,559,1815,2634,5036
62,Syria,2,2017,SYR-17/DDA-3558/Aleppo SA 2017/ERL/UN/4648,1945,2672,1881,1880,8378,1951,2681,1886,1885,8403
62,Syria,2,2017,SYR-17/DDA-3558/Aleppo SA 2017/S/NFI/NGO/4649,27,136,207,310,680,20,35,20,29,104
62,Syria,2,2017,SYR-17/DDA-3558/Aleppo SA 2017/H/UN/4650,12409,25368,8460,10148,56385,18470,33244,11090,11179,73983
62,Syria,2,2017,SYR-17/DDA-3558/Aleppo SA 2017/WASH-S/NFI/UN/4654,1710,2064,1261,1223,6258,1453,1754,1071,1039,5317
62,Syria,2,2017,SYR-17/DDA-3558/Aleppo SA 2017/ERL/NGO/4657,100,100,126,174,500,19,19,24,33,95
62,Syria,2,2017,SYR-17/DDA-3558/Aleppo SA 2017/H-WASH/INGO/4658,2646,2867,3970,4302,13785,2952,3072,3803,3958,13785
62,Syria,2,2017,SYR-17/DDA-3558/Aleppo SA 2017/S/NFI/NGO/4660,144,249,465,487,1345,31,42,23,52,148
62,Syria,2,2017,SYR-17/DDA-3558/Aleppo SA 2017/FSA/UN/4661,4182,8466,6126,6126,24900,0,0,0,0,0
62,Syria,2,2017,SYR-17/DDA-3558/Aleppo SA 2017/S/NFI/UN/4726,750,1200,510,540,3000,688,1100,468,495,2751
62,Syria,2,2017,SYR-17/DDA-3558/Aleppo SA 2017/H/NGO/4730,844,450,135,135,1564,90,2,0,0,92
62,Syria,2,2017,SYR-17/DDA-3558/Aleppo SA 2017/H/UN/4735,4600,10350,4140,3910,23000,0,0,0,0,0
62,Syria,2,2017,SYR-17/DDA-3558/Aleppo SA 2017/N/UN/4737,0,13500,59916,59917,133333,0,13500,59916,59917,133333
62,Syria,1,2017,SYR-17/DDA-3558/RA/CCS/UN/4968,1,0,0,0,1,3,2,0,0,5
62,Syria,1,2017,SYR-17/DDA-3558/RA/H/NGO/5170,7100,5624,8,12,12744,7907,6782,3,1,14693
62,Syria,1,2017,SYR-17/DDA-3558/RA/LOG/UN/5291,1,0,0,0,1,1,0,0,0,1
62,Syria,1,2017,SYR-17/DDA-3558/RA/LOG/UN/5324,1,0,0,0,1,1,0,0,0,1
62,Syria,1,2017,SYR-17/DDA-3558/RA/LOG/UN/6295,1,0,0,0,1,1,0,0,0,1
62,Syria,2,2017,SYR-17/DDA-3558/Aleppo SA 2017/ERL/UN/6447,345,345,147,148,985,0,0,0,0,0
62,Syria,1,2017,SYR-17/DDA-3558/RA/S/NFI/UN/6646,1,0,0,0,1,1,0,0,0,1
62,Syria,1,2017,SYR-17/DDA-3558/RA/H/UN/7327,650,600,0,0,1250,800,725,0,0,1525
62,Syria,2,2017,SYR-17/DDA-3558/NE Standard Allocation/WASH/INGO/7365,38020,40640,24911,27531,131102,11432,12220,7491,8278,39421
62,Syria,2,2017,SYR-17/DDA-3558/NE Standard Allocation/S/NFI/NGO/7398,15000,22500,18750,26250,82500,16802,29619,43601,43606,133628
62,Syria,2,2017,SYR-17/DDA-3558/NE Standard Allocation/FSA/NGO/7499,10650,10650,15975,15975,53250,15973,16582,29347,28667,90569
62,Syria,2,2017,SYR-17/DDA-3558/NE Standard Allocation/S/NFI/UN/7503,510,1014,2038,2038,5600,0,0,0,0,0
62,Syria,2,2017,SYR-17/DDA-3558/NE Standard Allocation/S/NFI/UN/7521,0,0,17887,17888,35775,0,0,17886,17886,35772
62,Syria,2,2017,SYR-17/DDA-3558/NE Standard Allocation/WASH/INGO/7532,20581,22865,34298,36586,114330,321,1488,23,5,1837
62,Syria,2,2017,SYR-17/DDA-3558/NE Standard Allocation/N/UN/7561,0,31511,27526,27526,86563,0,17674,19174,19956,56804
62,Syria,2,2017,SYR-17/DDA-3558/NE Standard Allocation/S/NFI/UN/7562,7350,8400,9800,9450,35000,4471,5110,5961,5748,21290
62,Syria,2,2017,SYR-17/DDA-3558/NE Standard Allocation/H/INGO/7574,11046,16371,12865,19252,59534,3260,4906,3902,6276,18344
62,Syria,2,2017,SYR-17/DDA-3558/NE Standard Allocation/H/UN/7577,1500,15875,5938,8437,31750,821,26795,1238,8535,37389
62,Syria,2,2017,SYR-17/DDA-3558/NE Standard Allocation/P/UN/7578,0,12600,0,5400,18000,0,8600,0,3755,12355
62,Syria,1,2018,SYR-18/DDA-3558/RA1/WASH-S/NFI/INGO/8812,28765,43147,11506,12465,95883,8364,12547,3346,3625,27882
62,Syria,1,2018,SYR-18/DDA-3558/RA1/H/UN/8814,16000,22400,3900,6352,48652,9585,13562,2397,3595,29139
62,Syria,1,2018,SYR-18/DDA-3558/AR/FSA/O/8818,8140,18993,8141,18994,54268,0,0,0,0,0
62,Syria,1,2018,SYR-18/DDA-3558/RA1/S/NFI-WASH/INGO/8820,13408,15922,5447,7123,41900,14108,16755,5732,7495,44090
62,Syria,1,2018,SYR-18/DDA-3558/RA1/S/NFI/NGO/8823,6000,6000,13000,13000,38000,7935,9360,13692,13137,44124
62,Syria,1,2018,SYR-18/DDA-3558/RA1/S/NFI-WASH-P/INGO/8826,6713,6713,5275,5274,23975,3296,3284,2991,2864,12435
62,Syria,1,2018,SYR-18/DDA-3558/RA1/N/UN/8838,0,25000,21000,21000,67000,0,22072,22536,22540,67148
62,Syria,1,2018,SYR-18/DDA-3558/RA1/WASH/UN/8840,42500,57500,35000,35000,170000,34000,35000,25000,26000,120000
62,Syria,1,2018,SYR-18/DDA-3558/RA1/S/NFI/INGO/8842,2700,3450,2775,2775,11700,2700,3450,2775,2775,11700
62,Syria,1,2018,SYR-18/DDA-3558/RA1/S/NFI/UN/8845,0,0,15067,15067,30134,0,0,15111,15111,30222
62,Syria,1,2018,SYR-18/DDA-3558/RA1/FSA/INGO/8846,1000,3000,2000,2000,8000,400,3200,2200,2200,8000
62,Syria,1,2018,SYR-18/DDA-3558/RA1/P/UN/8848,3828,33506,6846,18083,62263,1785,24248,3663,7864,37560
62,Syria,1,2018,SYR-18/DDA-3558/RA1/H/UN/8849,1000,20000,750,10250,32000,8820,30028,2787,9248,50883
62,Syria,1,2018,SYR-18/DDA-3558/RA1/S/NFI-P/UN/8850,10230,11456,13510,12849,48045,9837,11240,13115,12645,46837
62,Syria,1,2018,SYR-18/DDA-3558/RA1/S/NFI/UN/8852,0,0,42182,42181,84363,0,0,42182,42181,84363
62,Syria,1,2018,SYR-18/DDA-3558/RA1/P/UN/8854,4500,4500,15000,15000,39000,174,118,14116,13381,27789
62,Syria,1,2018,SYR-18/DDA-3558/RA1/WASH-H/O/8866,29035,35487,21903,25771,112196,10869,15186,16615,20551,63221
62,Syria,1,2018,SYR-18/DDA-3558/RA1/S/NFI/INGO/8867,1069,1603,3028,3206,8906,0,0,0,0,0
62,Syria,1,2018,SYR-18/DDA-3558/RA1/WASH/INGO/8868,1580,2580,9120,10480,23760,0,0,0,0,0
62,Syria,1,2018,SYR-18/DDA-3558/RA1/H-P-WASH/INGO/8869,9811,14717,6273,9409,40210,4237,2186,1455,1259,9137
62,Syria,1,2018,SYR-18/DDA-3558/RA1/H/UN/8877,10000,40000,46500,46500,143000,9000,26050,39680,41020,115750
62,Syria,1,2018,SYR-18/DDA-3558/AR/S/NFI/UN/9223,2310,2640,3080,2970,11000,920,1122,1305,1253,4600
70,Turkey,2,2014,TUR-14/CP/H/NGO/1065,0,3100,1500,1600,6200,0,16707,8138,7696,32541
70,Turkey,2,2014,TUR-14/CP/H/NGO/1072,947,418,157,74,1596,2018,617,271,109,3015
70,Turkey,2,2014,TUR-14/CP/WASH/NGO/1079,11740,14654,14088,17618,58100,9262,10238,14335,16165,50000
70,Turkey,2,2014,TUR-14/CP/H/NGO/1082,3900,2100,2320,1680,10000,7217,2145,1949,858,12169
70,Turkey,2,2014,TUR-14/CP/FS/INGO/1084,3075,4075,2775,2675,12600,3378,3998,5335,5697,18408
70,Turkey,2,2014,TUR-14/CP/NFI/UN/1091,8000,8000,16000,16000,48000,7191,7191,14383,14382,43147
70,Turkey,2,2014,TUR-14/CP/FS/UN/1095,3822,3978,0,0,7800,3022,2905,5905,5775,17607
70,Turkey,2,2014,TUR-14/CP/FS/NGO/1096,1180,1580,0,0,2760,3875,4405,8280,8280,24840
70,Turkey,2,2014,TUR-14/CP/P/NGO/1099,300,200,4000,6000,10500,242,160,4058,6000,10460
70,Turkey,2,2014,TUR-14/CP/FS/INGO/1100,500,500,1000,1000,3000,1475,1475,2950,2950,8850
70,Turkey,2,2014,TUR-14/CP/H/NGO/1101,0,1200,700,500,2400,0,758,432,360,1550
70,Turkey,2,2014,TUR-14/CP/WASH/NGO/1102,5130,7695,7270,9405,29500,5130,7695,7270,9405,29500
70,Turkey,2,2014,TUR-14/CP/H/NGO/1103,11440,3872,1408,880,17600,9704,4007,745,446,14902
70,Turkey,2,2014,TUR-14/CP/NFI/INGO/1104,1155,1155,1155,1155,4620,948,922,1957,1822,5649
70,Turkey,2,2014,TUR-14/CP/H/NGO/1108,17846,34910,11091,16453,80300,6900,18392,6994,8920,41206
70,Turkey,2,2014,TUR-14/CP/FS/NGO/1113,988,1382,1580,1580,5530,309,527,545,614,1995
70,Turkey,2,2014,TUR-14/CP/WASH/NGO/1114,44232,44568,11611,12041,112452,38910,41793,9340,10941,100984
70,Turkey,2,2014,TUR-14/CP/WASH/NGO/1115,9375,14625,3500,5000,32500,4374,7289,7292,10206,29161
70,Turkey,2,2014,TUR-14/CP/NFI/NGO/1120,14000,14000,27000,29000,84000,13255,15230,25322,31753,85560
70,Turkey,2,2014,TUR-14/CP/E/NGO/1121,412,585,6469,7581,15047,412,585,6469,7581,15047
70,Turkey,2,2014,TUR-14/CP/FS/NGO/1122,120,180,240,360,900,305,305,497,1248,2355
70,Turkey,2,2014,TUR-14/CP/P/NGO/1123,29,454,817,1075,2375,450,1500,1182,2841,5973
70,Turkey,2,2014,TUR-14/CP/CCM/INGO/1125,18668,18045,13690,11822,62225,22681,21925,16633,14365,75604
70,Turkey,2,2014,TUR-14/CP/E/NGO/1127,200,300,3000,4000,7500,75,107,3447,4921,8550
70,Turkey,2,2015,TUR-15/3559/CP/H/NGO/1153,17646,26957,14897,26957,86457,14428,40668,32238,29408,116742
70,Turkey,2,2015,TUR-15/3559/CP/FS/NGO/1160,377,125,0,0,502,379,123,1877,1225,3604
70,Turkey,2,2015,TUR-15/3559/CP/FS/INGO/1162,1535,500,0,0,2035,3318,3687,4977,6084,18066
70,Turkey,2,2015,TUR-15/3559/CP/FS/NGO/1163,2058,197,0,0,2255,2085,2293,4586,4586,13550
70,Turkey,2,2015,TUR-15/3559/CP/FS/NGO/1164,200,300,0,0,500,208,292,1177,1597,3274
70,Turkey,2,2015,TUR-15/3559/CP/FS/UN/1165,200,200,0,0,400,300,106,0,0,406
70,Turkey,2,2015,TUR-15/3559/CP/P/INGO/1166,0,872,66,770,1708,0,2084,68,380,2532
70,Turkey,2,2015,TUR-15/3559/CP/P/NGO/1169,500,1500,7000,7000,16000,1140,1766,7056,7263,17225
70,Turkey,2,2015,TUR-15/3559/CP/H/NGO/1171,69600,105000,37536,52704,264840,56696,32082,13812,14003,116593
70,Turkey,2,2015,TUR-15/3559/CP/E/INGO/1174,19,20,600,800,1439,25,12,709,744,1490
70,Turkey,2,2015,TUR-15/3559/CP/FS/INGO/1175,4803,6783,3996,4218,19800,5629,6629,7326,7364,26948
70,Turkey,2,2015,TUR-15/3559/CP/P/NGO/1178,148068,148676,164146,172413,633303,42120,39160,44500,50300,176080
70,Turkey,2,2015,TUR-15/3559/CP/H/NGO/1179,8914,19093,27176,29451,84634,39983,61360,32653,47596,181592
70,Turkey,2,2015,TUR-15/3559/CP/H/INGO/1182,28512,38016,14256,14256,95040,18819,22544,12404,13027,66794
70,Turkey,2,2015,TUR-15/3559/CP/E/NGO/1187,157,216,2506,2251,5130,157,216,2506,2251,5130
70,Turkey,2,2015,TUR-15/3559/CP/FS/INGO/1188,2244,2244,4356,4356,13200,3069,3514,4385,3886,14854
70,Turkey,2,2015,TUR-15/3559/CP/N/INGO/1189,0,5015,7168,6762,18945,2655,6993,9018,8060,26726
70,Turkey,2,2015,TUR-15/3559/CP/H/NGO/1191,9900,33100,19720,14280,77000,10773,30868,21378,19865,82884
70,Turkey,2,2015,TUR-15/3559/CP/FS/NGO/1192,3219,3219,4292,4599,15329,7810,7688,5161,4729,25388
70,Turkey,2,2015,TUR-15/3559/CP/FS/NGO/1196,800,200,0,0,1000,1942,458,7264,7284,16948
70,Turkey,2,2015,TUR-15/3559/CP/FS/UN/1202,1641,2441,0,0,4082,1694,271,2069,306,4340
70,Turkey,2,2015,TUR-15/3559/CP/N/NGO/1204,1800,80000,25000,25000,131800,1827,45017,39813,39028,125685
70,Turkey,2,2015,TUR-15/3559/CP/H/INGO/1206,1500,37000,25000,25000,88500,1005,44500,14724,13769,73998
70,Turkey,2,2015,TUR-15/3559/CP/P/NGO/1210,25610,64288,19129,19129,128156,42270,94608,55960,57479,250317
70,Turkey,2,2015,TUR-15/3559/CP/FS/NGO/1214,18100,21100,30150,31150,100500,17500,20500,23000,26050,87050
70,Turkey,2,2015,TUR-15/3559/CP/H/NGO/1223,16350,32550,16200,16200,81300,18167,20436,14992,13532,67127
70,Turkey,2,2015,TUR-15/3559/CP/N/NGO/1226,0,18000,13500,14580,46080,0,20336,12507,12440,45283
70,Turkey,2,2015,TUR-15/3559/CP/H/NGO/1229,17351,26021,3978,3672,51022,15801,27059,11458,9914,64232
70,Turkey,2,2015,TUR-15/3559/CP/N/NGO/1232,0,0,6885,8415,15300,0,38867,14259,14457,67583
70,Turkey,2,2015,TUR-15/3559/CP/E/NGO/1234,68,73,888,771,1800,64,71,945,964,2044
70,Turkey,2,2015,TUR-15/3559/CP/FS/NGO/1244,403,267,0,0,670,985,1210,954,995,4144
70,Turkey,2,2015,TUR-15/3559/CP/H/NGO/1245,2340,2908,1830,1170,8248,3269,3762,1385,1560,9976
70,Turkey,2,2015,TUR-15/3559/CP/H/NGO/1246,5063,9923,4860,4860,24706,7416,7606,3245,3543,21810
70,Turkey,2,2015,TUR-15/3559/CP/E/NGO/1256,0,0,4000,5000,9000,15,35,4059,5262,9371
70,Turkey,2,2015,TUR-15/3559/CP/FS/NGO/1260,200,0,0,0,200,191,200,332,278,1001
70,Turkey,2,2015,TUR-15/3559/CP/H/NGO/1263,0,20000,4000,4000,28000,0,23772,6210,6503,36485
70,Turkey,1,2015,TUR-15/3559/R/H/NGO/1268,4636,2086,2668,2200,11590,15825,7789,6066,3569,33249
70,Turkey,1,2015,TUR-15/3559/R/NFI/UN/1269,3700,3700,7400,7400,22200,3700,3700,7429,7429,22258
70,Turkey,1,2015,TUR-15/3559/R/H/NGO/1270,5600,6100,6000,5724,23424,1070,1294,458,358,3180
70,Turkey,1,2015,TUR-15/3559/R/WASH/NGO/1271,13800,23830,18460,26290,82380,16890,29277,23039,32795,102001
70,Turkey,1,2015,TUR-15/3559/R/FS/UN/1272,21507,22610,27372,28776,100265,24897,26174,31688,33313,116072
70,Turkey,1,2015,TUR-15/3559/R/FS/NGO/1274,2526,3100,2300,2600,10526,2526,3100,2300,2600,10526
70,Turkey,1,2015,TUR-15/3559/R/NFI/INGO/1275,850,850,1700,1700,5100,1131,1131,2261,2261,6784
70,Turkey,1,2015,TUR-15/3559/R/WASH/INGO/1277,29400,30600,29400,30600,120000,29400,30600,29400,30600,120000
70,Turkey,1,2015,TUR-15/3559/R/H/NGO/1278,2954,2953,2417,2416,10740,4950,1700,1200,1200,9050
70,Turkey,1,2015,TUR-15/3559/R/FS/INGO/1279,5627,5990,3448,3085,18150,4194,4465,2571,2300,13530
70,Turkey,1,2015,TUR-15/3559/R/CCS/UN/1557,106,106,0,0,212,200,130,0,0,330
70,Turkey,1,2015,TUR-15/3559/R/L/O/1732,0,0,0,0,0,0,0,0,0,0
70,Turkey,2,2015,TUR-15/3559/SA2/NFI/NGO/1777,115,155,264,248,782,132,161,263,251,807
70,Turkey,2,2015,TUR-15/3559/SA2/N/NGO/1821,165,12405,0,0,12570,165,12405,0,0,12570
70,Turkey,2,2015,TUR-15/3559/SA2/CCM/NGO/1826,45630,51374,38458,50035,185497,156178,163435,203865,211013,734491
70,Turkey,2,2015,TUR-15/3559/SA2/E/NGO/1828,0,0,10900,12300,23200,0,0,10900,12300,23200
70,Turkey,2,2015,TUR-15/3559/SA2/FS/NGO/1830,150,425,0,0,575,221,351,1715,1772,4059
70,Turkey,2,2015,TUR-15/3559/SA2/WASH/INGO/1838,9310,10780,14700,14210,49000,4894,5669,7727,7470,25760
70,Turkey,2,2015,TUR-15/3559/SA2/CCM/NGO/1842,1923,2309,1308,2155,7695,1821,2076,1795,2131,7823
70,Turkey,2,2015,TUR-15/3559/SA2/P/NGO/1849,1585,6339,679,2717,11320,2196,8983,1247,3225,15651
70,Turkey,2,2015,TUR-15/3559/SA2/P/NGO/1850,100,520,120,420,1160,465,1277,379,1643,3764
70,Turkey,2,2015,TUR-15/3559/SA2/FS/INGO/1863,210,390,0,0,600,802,184,0,0,986
70,Turkey,2,2015,TUR-15/3559/SA2/H/INGO/1866,34200,21280,10640,9880,76000,0,0,0,0,0
70,Turkey,2,2015,TUR-15/3559/SA2/FS/NGO/1880,1500,300,0,0,1800,5189,3376,3461,2711,14737
70,Turkey,2,2015,TUR-15/3559/SA2/P/INGO/1883,1200,1500,1950,1950,6600,2581,2653,4279,4718,14231
70,Turkey,2,2015,TUR-15/3559/SA2/H/INGO/1885,1600,1200,480,720,4000,1512,1120,501,709,3842
70,Turkey,2,2015,TUR-15/3559/SA2/WASH/NGO/1889,28499,48616,36881,53645,167641,29325,46963,37205,55413,168906
70,Turkey,2,2015,TUR-15/3559/SA2/NFI/INGO/1892,642,857,1052,1949,4500,793,912,2065,2300,6070
70,Turkey,2,2015,TUR-15/3559/SA2/WASH/INGO/1895,13000,21000,15000,19000,68000,10500,18250,9500,13000,51250
70,Turkey,2,2015,TUR-15/3559/SA2/P/NGO/1898,0,939,120,241,1300,65,3732,63,222,4082
70,Turkey,2,2015,TUR-15/3559/SA2/WASH/INGO/1900,2400,3600,3600,5400,15000,1855,3256,3261,5445,13817
70,Turkey,2,2015,TUR-15/3559/SA2/H/NGO/1901,9900,18270,4950,4950,38070,19309,28318,6557,5695,59879
70,Turkey,2,2015,TUR-15/3559/SA2/E/INGO/1904,101,95,2021,2606,4823,101,95,1905,2559,4660
70,Turkey,2,2015,TUR-15/3559/SA2/P/INGO/1909,45,89,1887,2333,4354,67,65,2591,2136,4859
70,Turkey,2,2015,TUR-15/3559/SA2/N/NGO/1910,10003,38882,6108,5868,60861,10421,28081,8056,7741,54299
70,Turkey,2,2015,TUR-15/3559/SA2/FS/INGO/1912,175,175,0,0,350,361,475,665,631,2132
70,Turkey,2,2015,TUR-15/3559/SA2/H/NGO/1913,2850,2490,1338,690,7368,2822,2199,1385,917,7323
70,Turkey,2,2015,TUR-15/3559/SA2/E/NGO/1914,0,0,225,300,525,0,24,103,390,517
70,Turkey,2,2015,TUR-15/3559/SA2/E/NGO/1915,45,65,840,1260,2210,45,65,840,1260,2210
70,Turkey,2,2015,TUR-15/3559/SA2/CCM/NGO/1917,1522,1802,3756,3781,10861,3236,3429,3835,3838,14338
70,Turkey,2,2015,TUR-15/3559/SA2/CCM/INGO/1918,1860,2266,3070,2857,10053,1881,2178,2772,3069,9900
70,Turkey,2,2015,TUR-15/3559/SA2/FS/NGO/1921,130,170,0,0,300,131,174,236,303,844
70,Turkey,2,2015,TUR-15/3559/SA2/WASH/INGO/1922,54720,62907,50435,50336,218398,50108,56121,46098,48103,200430
70,Turkey,2,2015,TUR-15/3559/SA2/CCM/INGO/1926,2013,2331,3602,2649,10595,2558,2962,4578,3367,13465
70,Turkey,1,2015,TUR-15/3559/RB2/CCM/UN/2077,6000,6000,12000,12000,36000,6668,6668,13338,13338,40012
70,Turkey,1,2015,TUR-15/3559/R/CCS/INGO/2078,0,0,0,0,0,151,46,0,0,197
70,Turkey,1,2015,TUR-15/3559/RB2/WASH/INGO/2081,123957,122915,102307,84691,433870,133774,133774,89183,89183,445914
70,Turkey,1,2015,TUR-15/3559/RB2/H/UN/2082,34535,35311,20228,19941,110015,34535,35311,20228,19941,110015
70,Turkey,1,2015,TUR-15/3559/RB2/NFI/INGO/2088,5376,5376,5376,5376,21504,4829,5881,7068,7593,25371
70,Turkey,1,2015,TUR-15/3559/RB2/FS/INGO/2089,38871,46275,48977,50976,185099,42383,46147,62251,60337,211118
70,Turkey,1,2015,TUR-15/3559/RB2/CCM/O/2261,2000,2000,2500,3500,10000,2000,2000,2500,3500,10000
70,Turkey,1,2015,TUR-15/3559/R/P/UN/2290,217400,211000,127310,124290,680000,84711,106071,812452,849180,1852414
70,Turkey,1,2015,TUR-15/3559/R/CCM/INGO/2321,21920,19289,21043,25427,87679,25234,22206,24225,29272,100937
70,Turkey,1,2016,TUR-16/3559/RA/H/INGO/2398,25175,45848,23593,25874,120490,20667,42901,24927,20030,108525
70,Turkey,1,2016,TUR-16/3559/RA/FS/INGO/2408,4200,4600,5400,5800,20000,12640,14517,17240,15335,59732
70,Turkey,1,2016,TUR-16/3559/RA/FS/INGO/2412,1570,1890,3220,3460,10140,1825,2036,3195,3084,10140
70,Turkey,1,2016,TUR-16/3559/RA/FS/INGO/2414,100,100,100,200,500,1100,1100,1100,2200,5500
70,Turkey,1,2016,TUR-16/3559/RA/NFI/INGO/2421,2168,2434,4466,4478,13546,3880,3841,3611,2719,14051
70,Turkey,1,2016,TUR-16/3559/RA/WASH/INGO/2427,6377,7134,9292,8379,31182,8196,9489,12078,13371,43134
70,Turkey,1,2016,TUR-16/3559/RA/FS/NGO/2429,12483,12991,8322,8662,42458,23220,23917,15443,16074,78654
70,Turkey,1,2016,TUR-16/3559/RA/P/INGO/2431,894,6942,3456,10368,21660,2377,5323,11575,11990,31265
70,Turkey,1,2016,TUR-16/3559/RA/H/NGO/2432,5656,12373,8484,8838,35351,12324,25352,12908,17571,68155
70,Turkey,1,2016,TUR-16/3559/RA/FS/INGO/2433,484,486,960,980,2910,584,713,958,1145,3400
70,Turkey,1,2016,TUR-16/3559/RA/WASH/INGO/2434,5400,8100,6615,6885,27000,10949,16423,13412,13959,54743
70,Turkey,1,2016,TUR-16/3559/RA/NFI/UN/2439,8000,8000,16000,16000,48000,8923,8923,17846,17846,53538
70,Turkey,1,2016,TUR-16/3559/RA/FS/INGO/2441,819,855,1623,1623,4920,2641,2839,4889,4931,15300
70,Turkey,1,2016,TUR-16/3559/RA/FS/INGO/2442,1500,2250,1875,1875,7500,2201,1933,3936,4000,12070
70,Turkey,1,2016,TUR-16/3559/RA/FS/NGO/2443,1914,3451,3335,5800,14500,1914,3451,3335,5800,14500
70,Turkey,1,2016,TUR-16/3559/RA/WASH/INGO/2444,11625,19375,20925,25575,77500,32897,54826,59213,72371,219307
70,Turkey,1,2016,TUR-16/3559/RA/CCM/INGO/2448,240,528,400,432,1600,1597,1178,1446,1843,6064
70,Turkey,1,2016,TUR-16/3559/RA/NFI/INGO/2455,5420,5567,1905,1758,14650,6308,6759,4506,4857,22430
70,Turkey,1,2016,TUR-16/3559/RA/NFI/INGO/2456,1335,1335,1335,1335,5340,1619,1703,2543,3021,8886
70,Turkey,1,2016,TUR-16/3559/RA/CCM/INGO/2460,7455,7657,2620,2418,20150,7743,8051,12057,11723,39574
70,Turkey,1,2016,TUR-16/3559/RA/WASH/INGO/2466,22189,20163,29257,29233,100842,22105,20102,29144,29131,100482
70,Turkey,1,2016,TUR-16/3559/RA/H/NGO/2467,8521,8522,3443,2692,23178,7328,4336,6518,3738,21920
70,Turkey,1,2016,TUR-16/3559/RA/H/INGO/2468,9563,7654,5655,4748,27620,9428,6019,4849,3537,23833
70,Turkey,1,2016,TUR-16/3559/RA/CCM/NGO/2471,10380,18164,8823,14531,51898,6626,8269,13236,11403,39534
70,Turkey,1,2016,TUR-16/3559/RA/CCM/INGO/2473,6274,7594,9359,10617,33844,19184,21399,29740,30916,101239
70,Turkey,1,2016,TUR-16/3559/RA/WASH/NGO/2507,1464,2034,1621,2172,7291,1464,2034,1621,2172,7291
70,Turkey,1,2016,TUR-16/3559/RA/WASH/INGO/2524,6486,6962,10046,10190,33684,6486,6962,10046,10190,33684
70,Turkey,1,2016,TUR-16/3559/RA/WASH/INGO/2527,10000,15000,17500,7500,50000,15084,16297,21025,18141,70547
70,Turkey,1,2016,TUR-16/3559/RA/WASH/NGO/2529,13909,15730,17046,15815,62500,6831,6831,8316,7722,29700
70,Turkey,1,2016,TUR-16/3559/RA/CCM/INGO/2530,1032,2268,1435,2450,7185,1803,3112,2190,3337,10442
70,Turkey,1,2016,TUR-16/3559/RA/H/NGO/2531,4425,4680,5135,5260,19500,4231,6188,1588,1519,13526
70,Turkey,1,2016,TUR-16/3559/RA/H/NGO/2546,0,0,40000,45000,85000,0,0,33172,35936,69108
70,Turkey,1,2016,TUR-16/3559/RA/H/INGO/2548,3000,1700,315963,328196,648859,4656,1320,281791,292463,580230
70,Turkey,2,2016,TUR-16/3559/SA 2016/P/INGO/2586,1178,1241,5244,5838,13501,5944,2954,8671,9756,27325
70,Turkey,2,2016,TUR-16/3559/SA 2016/H/INGO/2599,3854,21436,10704,11955,47949,3900,14273,12640,13112,43925
70,Turkey,2,2016,TUR-16/3559/SA 2016/P/NGO/2600,900,2200,8700,9000,20800,880,2170,8115,8098,19263
70,Turkey,2,2016,TUR-16/3559/SA 2016/E/NGO/2612,1400,1400,1125,1575,5500,1400,1400,1125,1575,5500
70,Turkey,2,2016,TUR-16/3559/SA 2016/H/INGO/2706,15692,37254,19766,23200,95912,10313,33109,17516,24477,85415
70,Turkey,2,2016,TUR-16/3559/SA 2016/E/INGO/2707,127,80,1721,1494,3422,200,148,3139,3157,6644
70,Turkey,2,2016,TUR-16/3559/SA 2016/H/NGO/2712,20228,45487,18533,22570,106818,25145,37680,23306,22920,109051
70,Turkey,2,2016,TUR-16/3559/SA 2016/CCM/NGO/2719,39,23,0,0,62,39,23,0,0,62
70,Turkey,2,2016,TUR-16/3559/SA 2016/E/NGO/2720,44,22,756,973,1795,50,21,756,973,1800
70,Turkey,2,2016,TUR-16/3559/SA 2016/WASH/NGO/2721,27215,42485,33890,46410,150000,25492,32040,43381,50887,151800
70,Turkey,2,2016,TUR-16/3559/SA 2016/WASH/NGO/2723,2200,7700,5500,6600,22000,2200,7700,5500,6600,22000
70,Turkey,2,2016,TUR-16/3559/SA 2016/FS/INGO/2725,1374,1156,2727,4090,9347,1374,1156,2727,4090,9347
70,Turkey,2,2016,TUR-16/3559/SA 2016/WASH/INGO/2729,9528,16454,12917,12158,51057,11281,19000,14844,14249,59374
70,Turkey,2,2016,TUR-16/3559/SA 2016/FS/INGO/2733,202,92,555,563,1412,202,92,555,563,1412
70,Turkey,2,2016,TUR-16/3559/SA 2016/H/NGO/2736,0,33000,1320,1980,36300,0,44356,2148,3300,49804
70,Turkey,2,2016,TUR-16/3559/SA 2016/E/NGO/2738,223,240,2133,2645,5241,222,240,2134,2645,5241
70,Turkey,2,2016,TUR-16/3559/SA 2016/H-N/NGO/2739,0,4200,17084,15120,36404,0,14955,13375,14283,42613
70,Turkey,2,2016,TUR-16/3559/SA 2016/WASH-E/NGO/2746,22890,26878,21479,25276,96523,21061,22021,26270,27331,96683
70,Turkey,2,2016,TUR-16/3559/SA 2016/P/INGO/2749,1698,2752,3188,3547,11185,3486,4215,5233,6130,19064
70,Turkey,2,2016,TUR-16/3559/SA 2016/E/NGO/2750,210,2155,1200,1110,4675,4352,3982,7334,8035,23703
70,Turkey,2,2016,TUR-16/3559/SA 2016/H/NGO/2752,2017,841,336,168,3362,1449,603,678,474,3204
70,Turkey,2,2016,TUR-16/3559/SA 2016/H-N/NGO/2754,8000,17500,11025,13475,50000,16043,60559,23304,30366,130272
70,Turkey,2,2016,TUR-16/3559/SA 2016/FS/NGO/2755,567,533,0,0,1100,903,947,2553,2659,7062
70,Turkey,2,2016,TUR-16/3559/SA 2016/H/NGO/2757,30738,71934,26968,36993,166633,27372,69572,32391,29080,158415
70,Turkey,2,2016,TUR-16/3559/SA 2016/CCM/INGO/2758,14395,14279,10059,9532,48265,14713,14587,10276,9740,49316
70,Turkey,2,2016,TUR-16/3559/SA 2016/FS/NGO/2760,140,210,875,875,2100,402,515,516,516,1949
70,Turkey,2,2016,TUR-16/3559/SA 2016/NFI/NGO/2762,250,350,300,600,1500,460,510,640,690,2300
70,Turkey,2,2016,TUR-16/3559/SA 2016/NFI/NGO/2765,370,403,425,427,1625,464,474,476,676,2090
70,Turkey,2,2016,TUR-16/3559/SA 2016/WASH/NGO/2766,13200,13200,26525,26525,79450,11052,12336,23229,26223,72840
70,Turkey,2,2016,TUR-16/3559/SA 2016/H-N/NGO/2767,7441,25427,20184,21132,74184,11532,30781,25052,22347,89712
70,Turkey,2,2016,TUR-16/3559/SA 2016/P/INGO/2769,9500,13000,19500,19500,61500,11651,14364,21395,21772,69182
70,Turkey,2,2016,TUR-16/3559/SA 2016/P/INGO/2770,13102,16751,14419,12408,56680,14604,20676,21728,17086,74094
70,Turkey,2,2016,TUR-16/3559/SA 2016/FS/NGO/2771,746,787,774,758,3065,794,803,888,871,3356
70,Turkey,2,2016,TUR-16/3559/SA 2016/NFI/NGO/2775,1160,1225,1230,1285,4900,728,1094,1547,1447,4816
70,Turkey,2,2016,TUR-16/3559/SA 2016/NFI/INGO/2776,4823,6416,6867,7694,25800,4300,5614,7711,7666,25291
70,Turkey,2,2016,TUR-16/3559/SA 2016/H/NGO/2778,14144,20768,13424,15194,63530,21918,26871,17039,19720,85548
70,Turkey,2,2016,TUR-16/3559/SA 2016/FS/UN/2779,4475,1525,0,0,6000,3048,1004,1127,371,5550
70,Turkey,2,2016,TUR-16/3559/SA 2016/WASH/NGO/2780,39566,44096,31124,40714,155500,32603,30232,26675,29048,118558
70,Turkey,2,2016,TUR-16/3559/SA 2016/CCM/NGO/2783,3120,4000,2840,2840,12800,2021,2780,1803,1910,8514
70,Turkey,2,2016,TUR-16/3559/SA 2016/E/NGO/2785,85,63,1086,1158,2392,135,119,1762,1991,4007
70,Turkey,1,2016,TUR-16/3559/RA/WASH/UN/3171,25000,25000,25000,25000,100000,17891,24446,48536,45823,136696
70,Turkey,1,2016,TUR-16/3559/RA/NFI/UN/3173,5000,5000,10000,10000,30000,6187,6187,10999,11000,34373
70,Turkey,1,2016,TUR-16/3559/RA/CCM/UN/3174,15840,15840,32760,32760,97200,18304,19505,28191,26929,92929
70,Turkey,1,2016,TUR-16/3559/RA/NFI/UN/3177,0,0,9000,9000,18000,0,0,14412,15570,29982
70,Turkey,1,2016,TUR-16/3559/RA/H/UN/3178,393100,458800,196400,262100,1310400,393100,458800,196400,262100,1310400
70,Turkey,1,2016,TUR-16/3559/RA/FS/UN/3179,10200,1800,0,0,12000,13646,2733,5932,1068,23379
70,Turkey,2,2016,TUR-16/3559/SA2/FS/NGO/3393,465,535,1861,2139,5000,777,1035,2255,2242,6309
70,Turkey,2,2016,TUR-16/3559/SA2/E/NGO/3428,37,55,400,700,1192,50,38,400,775,1263
70,Turkey,2,2016,TUR-16/3559/SA2/H-N/INGO/3444,4800,8200,4575,4875,22450,7954,9110,6918,4807,28789
70,Turkey,2,2016,TUR-16/3559/SA2/WASH/NGO/3489,2146,2090,2830,2924,9990,2701,3142,2721,2895,11459
70,Turkey,2,2016,TUR-16/3559/SA2/FS/NGO/3649,107,157,168,168,600,140,197,141,159,637
70,Turkey,2,2016,TUR-16/3559/SA2/CCM/NGO/3651,680,990,1800,1700,5170,1243,1028,1341,1067,4679
70,Turkey,2,2016,TUR-16/3559/SA2/E-P/NGO/3669,174,114,1489,1621,3398,174,114,1489,1621,3398
70,Turkey,2,2016,TUR-16/3559/SA2/H-N/NGO/3716,4902,9856,4310,4092,23160,7467,17652,3924,3502,32545
70,Turkey,2,2016,TUR-16/3559/SA2/N-H/NGO/3737,5000,75000,22500,22500,125000,308,35441,22629,23891,82269
70,Turkey,2,2016,TUR-16/3559/SA2/FS/NGO/3754,20250,19600,47850,48950,136650,29345,23450,55741,68954,177490
70,Turkey,2,2016,TUR-16/3559/SA2/P/NGO/3756,2653,5759,17299,17399,43110,4222,12996,49169,51314,117701
70,Turkey,2,2016,TUR-16/3559/SA2/FS/UN/3757,1350,450,0,0,1800,635,666,238,247,1786
70,Turkey,2,2016,TUR-16/3559/SA2/CCM/NGO/3758,11560,13988,14146,13221,52915,11344,13631,13708,12814,51497
70,Turkey,2,2016,TUR-16/3559/SA2/H/NGO/3761,10640,7581,6244,5054,29519,20153,10978,6219,2754,40104
70,Turkey,2,2016,TUR-16/3559/SA2/WASH/INGO/3769,1379,2236,2021,1847,7483,5217,5418,3817,3880,18332
70,Turkey,2,2016,TUR-16/3559/SA2/NFI/INGO/3770,5431,5431,4268,4268,19398,3656,4603,8051,8454,24764
70,Turkey,2,2016,TUR-16/3559/SA2/P/INGO/3773,5000,3000,4000,4000,16000,2104,2514,7130,7376,19124
70,Turkey,2,2016,TUR-16/3559/SA2/H/NGO/3780,14400,25600,6400,6000,52400,16150,24159,13720,10929,64958
70,Turkey,2,2016,TUR-16/3559/SA2/CCM/NGO/3781,2270,4205,2514,2647,11636,2270,4205,2514,2647,11636
70,Turkey,2,2016,TUR-16/3559/SA2/P/INGO/3782,250,1545,3950,6655,12400,2518,5308,8714,9793,26333
70,Turkey,2,2016,TUR-16/3559/SA2/P/NGO/3785,1584,3050,1900,3760,10294,2157,3246,3953,5231,14587
70,Turkey,2,2016,TUR-16/3559/SA2/FS/INGO/3788,6200,6050,6000,6000,24250,5544,5394,11088,11000,33026
70,Turkey,2,2016,TUR-16/3559/SA2/H-N/NGO/3790,19968,24960,13104,16848,74880,8995,18739,12211,12246,52191
70,Turkey,2,2016,TUR-16/3559/SA2/CCM/INGO/3792,5365,6213,9587,7050,28215,5568,6042,3999,3520,19129
70,Turkey,2,2016,TUR-16/3559/SA2/E/NGO/3794,127,142,3604,5218,9091,127,142,3604,5218,9091
70,Turkey,2,2016,TUR-16/3559/SA2/WASH/INGO/3799,9299,9977,11359,12003,42638,9395,10853,14808,13195,48251
70,Turkey,2,2016,TUR-16/3559/SA2/WASH/INGO/3808,7182,14363,5876,11752,39173,7182,14383,5876,11752,39193
70,Turkey,2,2016,TUR-16/3559/SA2/E/NGO/3813,16,19,489,320,844,34,1,402,304,741
70,Turkey,2,2016,TUR-16/3559/SA2/CCM-FS-NFI/UN/3818,11740,11700,43000,43000,109440,13596,12866,40030,39937,106429
70,Turkey,2,2016,TUR-16/3559/SA2/P/INGO/3821,230,2555,2735,3323,8843,789,4360,3874,5330,14353
70,Turkey,2,2016,TUR-16/3559/SA2/H-N/NGO/3834,10796,18641,7357,12269,49063,15379,19845,10378,8947,54549
70,Turkey,2,2016,TUR-16/3559/SA2/E/NGO/3835,21,136,1808,1846,3811,27,165,1982,1828,4002
70,Turkey,2,2016,TUR-16/3559/SA2/H/NGO/3837,11073,19127,7550,12584,50334,9051,4499,4492,2153,20195
70,Turkey,2,2016,TUR-16/3559/SA2/E/NGO/3842,42,48,706,734,1530,79,29,712,748,1568
70,Turkey,2,2016,TUR-16/3559/SA2/FS/NGO/3843,321,338,410,431,1500,391,447,558,543,1939
70,Turkey,2,2016,TUR-16/3559/SA2/FS/NGO/3852,950,350,1700,2200,5200,1005,295,3004,3522,7826
70,Turkey,2,2016,TUR-16/3559/SA2/P/NGO/3857,10,31242,20410,20970,72632,1758,31319,20283,26083,79443
70,Turkey,2,2016,TUR-16/3559/SA2/WASH/NGO/3858,19350,28500,25600,34050,107500,19350,28500,25600,34050,107500
70,Turkey,2,2016,TUR-16/3559/SA2/FS/NGO/3859,1020,1020,1980,1980,6000,791,1243,1436,1321,4791
70,Turkey,2,2016,TUR-16/3559/SA2/H/NGO/3860,2310,2695,1541,1155,7701,6723,3936,3120,1756,15535
70,Turkey,2,2016,TUR-16/3559/SA2/CCM/INGO/3861,3019,3319,4290,4306,14934,3285,3737,5086,5155,17263
70,Turkey,2,2016,TUR-16/3559/SA2/H/NGO/3862,23169,15268,10249,10793,59479,30892,13434,14351,10065,68742
70,Turkey,2,2016,TUR-16/3559/SA2/E/NGO/3866,60,90,1995,2435,4580,60,90,1995,2435,4580
70,Turkey,2,2016,TUR-16/3559/SA2/P/INGO/3867,17050,17050,25500,25500,85100,15695,16615,40805,36070,109185
70,Turkey,2,2016,TUR-16/3559/SA2/P/INGO/3868,7886,11184,11517,12355,42942,8706,12778,18593,18249,58326
70,Turkey,2,2016,TUR-16/3559/SA2/H/NGO/3869,4536,6804,7655,9355,28350,16290,32936,12888,25930,88044
70,Turkey,2,2016,TUR-16/3559/SA2/P/NGO/3871,230,121,0,0,351,361,77,0,0,438
70,Turkey,2,2016,TUR-16/3559/SA2/H/INGO/3874,13899,14279,7621,5153,40952,24311,21911,14805,10931,71958
70,Turkey,2,2016,TUR-16/3559/SA2/NFI/NGO/3875,4218,5328,5994,6660,22200,3860,5043,7325,7033,23261
70,Turkey,2,2016,TUR-16/3559/SA2/H/INGO/3876,2420,750,370,185,3725,3399,1166,486,218,5269
70,Turkey,2,2016,TUR-16/3559/SA2/H/NGO/3877,18714,21546,10631,11473,62364,20930,11116,9965,7835,49846
70,Turkey,2,2016,TUR-16/3559/SA2/E/NGO/3878,186,113,3170,2637,6106,117,75,2297,2427,4916
70,Turkey,2,2016,TUR-16/3559/SA2/FS/NGO/3879,800,900,1400,1700,4800,1415,1428,1501,1460,5804
70,Turkey,2,2016,TUR-16/3559/SA2/WASH/NGO/3881,7196,9678,11202,10738,38814,0,0,0,0,0
70,Turkey,2,2016,TUR-16/3559/SA2/P/INGO/3882,20,32,0,0,52,71,114,0,0,185
70,Turkey,2,2016,TUR-16/3559/SA2/E/NGO/3883,200,219,518,562,1499,251,164,588,551,1554
70,Turkey,1,2016,TUR-16/3559/RA/CCM/O/4457,5000,5000,7500,7500,25000,5000,5000,7500,7500,25000
70,Turkey,1,2016,TUR-16/3559/RA/CCM/UN/4459,9036,9036,18073,18074,54219,7545,9208,14015,13489,44257
70,Turkey,1,2016,TUR-16/3559/RA/WASH/NGO/4488,11880,10800,16200,15120,54000,17628,17967,15594,16611,67800
70,Turkey,1,2016,TUR-16/3559/RA/NFI/UN/4489,11700,11700,13400,13400,50200,10742,10975,15726,15965,53408
70,Turkey,1,2016,TUR-16/3559/RA/CCM/UN/4490,7200,7200,14400,14400,43200,1014,2181,2738,2658,8591
70,Turkey,1,2016,TUR-16/3559/RA/WASH/INGO/4493,38000,35200,30000,27600,130800,29176,29746,53497,43789,156208
70,Turkey,1,2016,TUR-16/3559/RA/FS/UN/4503,50759,53363,64603,67916,236641,44586,57962,55732,64650,222930
70,Turkey,1,2017,TUR-17/3559/RA/CCS/UN/4766,1070,430,0,0,1500,264,130,0,0,394
70,Turkey,1,2017,TUR-17/3559/RA/CCS/O/5030,1,1,1,1,4,1,1,1,1,4
70,Turkey,2,2017,TUR-17/3559/SA 2017/FS/NGO/5288,525,175,0,0,700,921,999,1494,1470,4884
70,Turkey,2,2017,TUR-17/3559/SA 2017/NFI/NGO/5294,430,455,935,780,2600,760,769,804,707,3040
70,Turkey,2,2017,TUR-17/3559/SA 2017/FS/INGO/5297,1570,721,0,0,2291,2318,455,0,0,2773
70,Turkey,2,2017,TUR-17/3559/SA 2017/E/NGO/5299,55,90,1200,1419,2764,80,109,1230,1399,2818
70,Turkey,2,2017,TUR-17/3559/SA 2017/H/NGO/5300,28356,16680,5560,5004,55600,33457,16135,16799,12674,79065
70,Turkey,2,2017,TUR-17/3559/SA 2017/P/UN/5302,2400,2400,4800,4800,14400,74,660,658,864,2256
70,Turkey,2,2017,TUR-17/3559/SA 2017/FS/NGO/5308,5996,6393,7846,9893,30128,7073,8343,13826,12604,41846
70,Turkey,2,2017,TUR-17/3559/SA 2017/WASH/INGO/5311,230458,221548,197199,241740,890945,229041,233700,263319,228181,954241
70,Turkey,2,2017,TUR-17/3559/SA 2017/H-N/NGO/5314,6390,13390,7571,7462,34813,5207,14691,8194,7886,35978
70,Turkey,2,2017,TUR-17/3559/SA 2017/CCM/NGO/5315,2919,3393,2901,3061,12274,2919,3393,2901,3061,12274
70,Turkey,2,2017,TUR-17/3559/SA 2017/P/NGO/5318,2310,8750,990,6750,18800,1272,3062,1267,2955,8556
70,Turkey,2,2017,TUR-17/3559/SA 2017/CCM/INGO/5321,11284,11284,13812,13812,50192,7882,9095,11602,9999,38578
70,Turkey,2,2017,TUR-17/3559/SA 2017/WASH/INGO/5323,5776,6383,9556,8054,29769,7045,8034,11743,10817,37639
70,Turkey,2,2017,TUR-17/3559/SA 2017/ER-NFI/UN/5327,2202,2132,4244,4244,12822,0,0,0,0,0
70,Turkey,2,2017,TUR-17/3559/SA 2017/ER/NGO/5328,434,200,0,0,634,164,0,0,0,164
70,Turkey,2,2017,TUR-17/3559/SA 2017/H/NGO/5331,17226,28388,8847,8548,63009,21245,28685,15923,13600,79453
70,Turkey,2,2017,TUR-17/3559/SA 2017/FS/INGO/5333,1280,1440,1927,1969,6616,945,1450,2262,2504,7161
70,Turkey,2,2017,TUR-17/3559/SA 2017/NFI/NGO/5335,256,358,606,608,1828,306,372,408,396,1482
70,Turkey,2,2017,TUR-17/3559/SA 2017/P/NGO/5338,900,2415,470,1115,4900,698,2138,447,1091,4374
70,Turkey,2,2017,TUR-17/3559/SA 2017/CCM/NGO/5340,778,934,940,878,3530,914,1098,1105,1033,4150
70,Turkey,2,2017,TUR-17/3559/SA 2017/ER/INGO/5345,276,288,312,324,1200,265,282,323,336,1206
70,Turkey,2,2017,TUR-17/3559/SA 2017/E/NGO/5347,61,69,1003,1207,2340,58,59,946,1143,2206
70,Turkey,2,2017,TUR-17/3559/SA 2017/NFI/NGO/5350,679,813,733,865,3090,744,760,982,963,3449
70,Turkey,2,2017,TUR-17/3559/SA 2017/ER/UN/5352,500,500,0,0,1000,0,0,0,0,0
70,Turkey,2,2017,TUR-17/3559/SA 2017/NFI/INGO/5353,2952,3076,3333,3469,12830,5188,6071,8315,8460,28034
70,Turkey,2,2017,TUR-17/3559/SA 2017/CCM/NGO/5354,2195,2484,2630,2670,9979,2490,3148,2880,3275,11793
70,Turkey,2,2017,TUR-17/3559/SA 2017/P/NGO/5359,309752,384564,162638,162638,1019592,362487,434632,190572,190572,1178263
70,Turkey,2,2017,TUR-17/3559/SA 2017/WASH/INGO/5366,7298,7911,8518,8224,31951,7298,7911,8518,8224,31951
70,Turkey,2,2017,TUR-17/3559/SA 2017/E/NGO/5371,42,70,1269,1431,2812,42,70,1161,638,1911
70,Turkey,2,2017,TUR-17/3559/SA 2017/E/NGO/5373,34,39,804,1113,1990,32,26,986,1023,2067
70,Turkey,2,2017,TUR-17/3559/SA 2017/FS/NGO/5375,150,1260,0,0,1410,685,1661,1964,1834,6144
70,Turkey,2,2017,TUR-17/3559/SA 2017/E/NGO/5378,235,127,1056,1182,2600,283,87,1920,1461,3751
70,Turkey,2,2017,TUR-17/3559/SA 2017/NFI/NGO/5379,664,731,948,1037,3380,643,722,684,613,2662
70,Turkey,2,2017,TUR-17/3559/SA 2017/P/NGO/5384,466,1466,3180,3920,9032,193,226,681,658,1758
70,Turkey,2,2017,TUR-17/3559/SA 2017/H-N/NGO/5390,10500,44170,13910,16410,84990,10500,44170,13910,16410,84990
70,Turkey,2,2017,TUR-17/3559/SA 2017/P/INGO/5396,4615,4997,8389,6999,25000,3885,4757,7987,6612,23241
70,Turkey,2,2017,TUR-17/3559/SA 2017/E/NGO/5399,1574,1555,1455,1685,6269,230,423,1966,1922,4541
70,Turkey,2,2017,TUR-17/3559/SA 2017/WASH/NGO/5400,1265,1898,1965,2401,7529,1914,1940,1989,1952,7795
70,Turkey,2,2017,TUR-17/3559/SA 2017/H/NGO/5401,0,27972,15951,17046,60969,0,27885,16733,15804,60422
70,Turkey,2,2017,TUR-17/3559/SA 2017/WASH/NGO/5405,16440,19727,23421,9930,69518,23956,25045,29401,30489,108891
70,Turkey,2,2017,TUR-17/3559/SA 2017/FS/UN/5407,1800,1800,1800,3600,9000,0,0,0,0,0
70,Turkey,2,2017,TUR-17/3559/SA 2017/H-N/UN/5409,90339,98917,64672,61176,315104,60000,62000,44000,41000,207000
70,Turkey,2,2017,TUR-17/3559/SA 2017/P/INGO/5412,2190,4410,1200,1500,9300,1404,3400,2747,3415,10966
70,Turkey,2,2017,TUR-17/3559/SA 2017/P/NGO/5432,1663,7394,11100,14492,34649,7027,26057,24320,35874,93278
70,Turkey,2,2017,TUR-17/3559/SA 2017/WASH/NGO/5468,2700,3300,3600,5400,15000,2700,3300,3600,5400,15000
70,Turkey,1,2017,TUR-17/3559/RA/P/UN/6248,100,100,0,0,200,100,100,0,0,200
70,Turkey,1,2017,TUR-17/3559/RA/P/NGO/6297,0,300,0,0,300,11,380,0,0,391
70,Turkey,1,2017,TUR-17/3559/RA/CCM/UN/6367,900,900,1800,1800,5400,0,0,0,0,0
70,Turkey,1,2017,TUR-17/3559/RA/CCS/NGO/6401,100,100,0,0,200,100,100,0,0,200
70,Turkey,2,2017,TUR-17/3559/SA2/NFI/INGO/6985,6293,7293,10337,10294,34217,5467,6234,9406,9357,30464
70,Turkey,2,2017,TUR-17/3559/SA2/H/NGO/6988,9426,7592,7074,6224,30316,13127,10804,4054,3444,31429
70,Turkey,2,2017,TUR-17/3559/SA2/P/NGO/6995,303,1058,300,779,2440,220,2393,107,602,3322
70,Turkey,2,2017,TUR-17/3559/SA2/H/NGO/7000,9680,10843,6757,6928,34208,15405,12446,8415,4912,41178
70,Turkey,2,2017,TUR-17/3559/SA2/E/NGO/7001,149,127,3832,4219,8327,168,226,3933,4118,8445
70,Turkey,2,2017,TUR-17/3559/SA2/H/INGO/7006,2304,15707,10801,9542,38354,2252,18451,12035,10718,43456
70,Turkey,2,2017,TUR-17/3559/SA2/H/NGO/7010,6138,8370,6454,6975,27937,19096,27753,6498,9831,63178
70,Turkey,2,2017,TUR-17/3559/SA2/P/NGO/7012,200,950,400,1350,2900,112,1122,329,1380,2943
70,Turkey,2,2017,TUR-17/3559/SA2/CCM/NGO/7020,1200,2000,1800,1800,6800,2064,2264,2692,2353,9373
70,Turkey,2,2017,TUR-17/3559/SA2/FS/NGO/7040,2262,2407,2598,2973,10240,1399,899,4296,3397,9991
70,Turkey,2,2017,TUR-17/3559/SA2/FS/INGO/7045,2400,2400,3096,4104,12000,466,466,601,796,2329
70,Turkey,2,2017,TUR-17/3559/SA2/P/NGO/7057,1680,1680,4670,4670,12700,183,299,12513,10111,23106
70,Turkey,2,2017,TUR-17/3559/SA2/FS/INGO/7064,539,356,381,424,1700,1603,97,0,0,1700
70,Turkey,2,2017,TUR-17/3559/SA2/P/NGO/7066,350,350,1175,1175,3050,448,299,1219,1229,3195
70,Turkey,2,2017,TUR-17/3559/SA2/H/NGO/7068,11200,17500,6600,6200,41500,8593,11242,9721,8118,37674
70,Turkey,2,2017,TUR-17/3559/SA2/E/NGO/7071,527,300,10291,12590,23708,509,679,15722,17668,34578
70,Turkey,2,2017,TUR-17/3559/SA2/P/NGO/7087,3100,3500,3400,4000,14000,1950,3219,4269,4261,13699
70,Turkey,2,2017,TUR-17/3559/SA2/H/INGO/7110,10315,22947,14599,13918,61779,10233,15226,12326,10672,48457
70,Turkey,2,2017,TUR-17/3559/SA2/E/NGO/7111,788,555,13364,12657,27364,806,563,13646,12934,27949
70,Turkey,2,2017,TUR-17/3559/SA2/FS/INGO/7124,100,1000,2000,2000,5100,524,1641,2077,1974,6216
70,Turkey,2,2017,TUR-17/3559/SA2/H/NGO/7176,5577,8676,8754,9456,32463,6746,12219,9670,8778,37413
70,Turkey,2,2017,TUR-17/3559/SA2/FS/NGO/7178,1911,2679,2559,2823,9972,2803,2947,1562,1577,8889
70,Turkey,2,2017,TUR-17/3559/SA2/NFI/INGO/7185,1217,1217,2434,2434,7302,0,0,0,0,0
70,Turkey,2,2017,TUR-17/3559/SA2/FS/NGO/7193,1368,1728,1944,2160,7200,1610,1717,2378,2023,7728
70,Turkey,2,2017,TUR-17/3559/SA2/P/NGO/7196,500,5364,2352,3478,11694,352,9506,1532,4419,15809
70,Turkey,2,2017,TUR-17/3559/SA2/E/NGO/7197,0,0,1450,1200,2650,0,0,1370,1403,2773
70,Turkey,2,2017,TUR-17/3559/SA2/NFI/INGO/7198,422,533,666,599,2220,537,395,719,822,2473
70,Turkey,2,2017,TUR-17/3559/SA2/H/NGO/7201,2650,7490,2100,1800,14040,4222,8446,1879,1688,16235
70,Turkey,2,2017,TUR-17/3559/SA2/NFI/NGO/7213,2230,2570,4450,5150,14400,2080,3264,4674,4467,14485
70,Turkey,2,2017,TUR-17/3559/SA2/CCM/NGO/7219,2722,2810,4131,3929,13592,3090,3427,3357,3753,13627
70,Turkey,2,2017,TUR-17/3559/SA2/H/NGO/7220,12216,24348,5994,5094,47652,12074,20504,6607,5791,44976
70,Turkey,2,2017,TUR-17/3559/SA2/NFI/O/7222,1458,2000,3692,3650,10800,1871,2301,3430,3293,10895
70,Turkey,2,2017,TUR-17/3559/SA2/P/NGO/7233,495,8860,1040,2170,12565,14221,18505,10884,12743,56353
70,Turkey,2,2017,TUR-17/3559/SA2/NFI/NGO/7236,1805,2916,2463,3107,10291,1396,2113,3177,3163,9849
70,Turkey,2,2017,TUR-17/3559/SA2/CCM/INGO/7237,5627,5499,5364,6104,22594,5627,5499,5364,6104,22594
70,Turkey,2,2017,TUR-17/3559/SA2/CCM/INGO/7239,29718,32692,20306,20125,102841,19704,23120,28584,25529,96937
70,Turkey,2,2017,TUR-17/3559/SA2/H/NGO/7250,8340,14863,8724,8160,40087,9756,22437,15025,13303,60521
70,Turkey,2,2017,TUR-17/3559/SA2/FS/NGO/7262,2000,2500,2500,3000,10000,1960,2036,2470,2996,9462
70,Turkey,2,2017,TUR-17/3559/SA2/H/INGO/7266,2388,3876,3528,3408,13200,2711,3926,3931,2998,13566
70,Turkey,2,2017,TUR-17/3559/SA2/E/NGO/7273,0,0,11999,12524,24523,0,0,16401,16047,32448
70,Turkey,1,2017,TUR-17/3559/RA2/WASH/INGO/7653,6794,6950,8963,9179,31886,14419,17113,13294,14910,59736
70,Turkey,1,2017,TUR-17/3559/RA2/WASH/NGO/7655,1931,3925,1595,3197,10648,2480,3530,3350,3470,12830
70,Turkey,1,2018,TUR-18/3559/RA1/NFI-CCM/UN/7767,13250,13250,27750,27750,82000,8965,8987,11610,11646,41208
70,Turkey,1,2018,TUR-18/3559/RA1/WASH/NGO/8280,28698,29627,56288,57573,172186,32913,35616,60290,63690,192509
70,Turkey,1,2018,TUR-18/3559/RA1/FS/INGO/8293,2336,2856,3894,3894,12980,3883,4481,7409,7455,23228
70,Turkey,1,2018,TUR-18/3559/RA1/NFI/NGO/8320,1832,2126,1319,2053,7330,1610,1452,1743,1764,6569
70,Turkey,1,2018,TUR-18/3559/RA1/CCM/O/8330,2939,3542,3556,3789,13826,603,603,904,904,3014
70,Turkey,1,2018,TUR-18/3559/RA1/P/INGO/8335,2849,5651,11210,8408,28118,57,56,2,21,136
70,Turkey,1,2018,TUR-18/3559/RA1/FS/NGO/8337,2640,3960,4554,5346,16500,3394,5824,5783,7531,22532
70,Turkey,1,2018,TUR-18/3559/RA1/N/INGO/8339,0,5862,4408,4090,14360,0,6941,7069,6779,20789
70,Turkey,1,2018,TUR-18/3559/RA1/H/NGO/8346,4650,4200,1500,1350,11700,2178,1382,1010,571,5141
70,Turkey,1,2018,TUR-18/3559/RA1/FS/NGO/8354,2561,2898,4960,4336,14755,11539,12496,16686,15339,56060
70,Turkey,1,2018,TUR-18/3559/RA1/N/NGO/8360,4500,12000,14343,13782,44625,2817,18031,18215,17624,56687
70,Turkey,1,2018,TUR-18/3559/RA1/H/INGO/8362,69042,95515,63459,51567,279583,99271,68066,98912,114974,381223
70,Turkey,1,2018,TUR-18/3559/RA1/N/O/8365,4529,5279,2573,2619,15000,5504,7453,4557,4329,21843
70,Turkey,1,2018,TUR-18/3559/RA1/H/NGO/8367,23689,24427,12588,13326,74030,13668,28549,17100,14763,74080
70,Turkey,1,2018,TUR-18/3559/RA1/WASH/NGO/8370,20120,26751,24213,23625,94709,15782,20932,22024,18395,77133
70,Turkey,1,2018,TUR-18/3559/RA1/P/NGO/8373,5500,5651,11210,8408,30769,327,408,449,391,1575
70,Turkey,1,2018,TUR-18/3559/RA2/H/NGO/8406,14907,17116,16011,15868,63902,13630,15653,15197,14971,59451
70,Turkey,1,2018,TUR-18/3559/RA3/NFI/UN/9001,10000,10000,20000,20000,60000,5341,5988,9821,9184,30334
70,Turkey,1,2018,TUR-18/3559/RA3/NFI/INGO/9014,300,300,600,600,1800,0,0,0,0,0
70,Turkey,1,2018,TUR-18/3559/RA3/FS/NGO/9020,3600,3600,2400,2400,12000,3458,3603,5331,4110,16502
70,Turkey,1,2018,TUR-18/3559/RA3/FS/NGO/9021,4375,5157,2654,3438,15624,0,0,0,0,0
70,Turkey,1,2018,TUR-18/3559/RA3/FS/NGO/9023,2969,3368,4284,3719,14340,2322,2181,2659,2802,9964
70,Turkey,1,2018,TUR-18/3559/RA3/FS/O/9024,1580,1580,1580,3160,7900,3667,2130,1815,2383,9995
70,Turkey,1,2018,TUR-18/3559/RA3/CCS/O/9219,1,1,1,1,4,1,1,1,1,4
70,Turkey,2,2018,TUR-18/3559/SA1/NFI/O/9488,275,315,470,470,1530,0,0,0,0,0
64,Yemen,1,2015,YEM-15/3420/RA/H/INGO/1280,22627,19027,14763,21269,77686,11696,19223,16102,16532,63553
64,Yemen,1,2015,YEM-15/3420/RA/H/NGO/1283,15600,23400,12740,13260,65000,12487,20180,17793,19493,69953
64,Yemen,1,2015,YEM-15/3420/RA/L/UN/1286,400,320,0,0,720,404,320,0,0,724
64,Yemen,1,2015,YEM-15/3420/RA/FS/INGO/1289,1934,2012,2011,2093,8050,1812,1304,2021,1902,7039
64,Yemen,1,2015,YEM-15/3420/RA/H/INGO/1299,544,256,0,0,800,452,348,0,0,800
64,Yemen,1,2015,YEM-15/3420/RA/NFI/INGO/1300,8580,7920,0,0,16500,2485,2293,0,0,4778
64,Yemen,1,2015,YEM-15/3420/RA/P/UN/1325,221,167,510,400,1298,0,0,0,0,0
64,Yemen,1,2015,YEM-15/3420/RA/H/NGO/1326,5500,6650,3900,3950,20000,13741,17872,6626,8618,46857
64,Yemen,1,2015,YEM-15/3420/RA/WASH/INGO/1349,17006,15698,0,0,32704,45861,44062,0,0,89923
64,Yemen,1,2015,YEM-15/3420/RA/FS/INGO/1351,2502,2203,4964,4857,14526,2523,2718,5144,5720,16105
64,Yemen,1,2015,YEM-15/3420/RA/P/INGO/1367,1048,1182,2330,2285,6845,12122,7007,38421,13146,70696
64,Yemen,1,2015,YEM-15/3420/RA/FS/INGO/1373,4064,4740,6773,6998,22575,3250,3649,5338,5417,17654
64,Yemen,1,2015,YEM-15/3420/RA/WASH/INGO/1381,7470,8217,10458,11205,37350,7923,7804,8797,8509,33033
64,Yemen,1,2015,YEM-15/3420/RA/N/INGO/1382,0,0,2050,2050,4100,0,0,736,699,1435
64,Yemen,1,2015,YEM-15/3420/RA/NFI/UN/1384,490,490,490,490,1960,666,687,313,294,1960
64,Yemen,1,2015,YEM-15/3420/RA/H/INGO/1393,14280,21420,17850,17850,71400,22289,34988,8339,8056,73672
64,Yemen,1,2015,YEM-15/3420/RA/NFI/UN/1398,8698,10873,10873,13047,43491,10259,15647,12347,8803,47056
64,Yemen,1,2015,YEM-15/3420/RA/FS/INGO/1401,0,0,0,0,0,3835,3992,3992,4155,15974
64,Yemen,1,2015,YEM-15/3420/RA/WASH/INGO/1405,4592,4510,6422,6182,21706,4879,4935,7740,8084,25638
64,Yemen,1,2015,YEM-15/3420/RA/H/INGO/1406,12201,12699,2499,2601,30000,9176,18585,12804,13081,53646
64,Yemen,1,2015,YEM-15/3420/RA2/H/INGO/1484,612,263,0,0,875,495,380,0,0,875
64,Yemen,1,2015,YEM-15/3420/RA2/WASH/INGO/1488,8471,8144,6045,7303,29963,11657,13108,2501,2833,30099
64,Yemen,1,2015,YEM-15/3420/RA2/H/INGO/1490,27322,28438,5998,6242,68000,8427,18914,7092,6758,41191
64,Yemen,1,2015,YEM-15/3420/RA2/NFI/NGO/1496,652,802,858,813,3125,646,863,800,816,3125
64,Yemen,1,2015,YEM-15/3420/RA2/WASH-H/NGO/1503,6000,9000,4750,5250,25000,7434,11155,7026,6170,31785
64,Yemen,1,2015,YEM-15/3420/RA2/P/INGO/1504,1800,1800,2700,2700,9000,2478,1969,1056,1274,6777
64,Yemen,1,2015,YEM-15/3420/RA2/WASH/INGO/1505,3821,4416,3167,3671,15075,6200,7208,5191,6003,24602
64,Yemen,1,2015,YEM-15/3420/RA2/H/INGO/1506,0,73354,0,0,73354,0,47341,0,0,47341
64,Yemen,1,2015,YEM-15/3420/RA2/P-NFI/NGO/1510,2915,3805,3182,3398,13300,2068,7223,1448,3110,13849
64,Yemen,1,2015,YEM-15/3420/RA2/WASH/INGO/1511,2975,2975,5775,5775,17500,2964,2948,5754,5723,17389
64,Yemen,1,2015,YEM-15/3420/RA2/WASH-H/NGO/1516,1333,1459,4695,5713,13200,2966,4497,2767,3188,13418
64,Yemen,1,2015,YEM-15/3420/RA2/NFI/NGO/1519,1614,1550,1242,1194,5600,1831,1729,1382,1358,6300
64,Yemen,1,2015,YEM-15/3420/RA2/H-WASH/NGO/1520,4059,8703,949,1196,14907,779,10288,4540,5706,21313
64,Yemen,1,2015,YEM-15/3420/RA2/NFI/INGO/1523,2981,4248,3361,4789,15379,3917,4017,6982,6816,21732
64,Yemen,1,2015,YEM-15/3420/RA2/NFI/INGO/1525,3293,3427,2195,2285,11200,4219,4391,2813,2927,14350
64,Yemen,1,2015,YEM-15/3420/RA2/WASH/INGO/1526,5460,5250,5248,5042,21000,15213,14126,13040,11952,54331
64,Yemen,1,2015,YEM-15/3420/RA2/H-WASH/NGO/1527,12000,14400,16128,17520,60048,7309,34979,16431,15831,74550
64,Yemen,1,2015,YEM-15/3420/RA2/WASH/INGO/1528,1436,1494,3589,3736,10255,2417,5161,10376,12178,30132
64,Yemen,1,2015,YEM-15/3420/RA2/NFI/INGO/1533,5748,6746,5298,6218,24010,5593,6254,9799,9051,30697
64,Yemen,1,2015,YEM-15/3420/RA3/H/INGO/1942,13852,29552,14400,14400,72204,13235,18802,11433,12708,56178
64,Yemen,1,2015,YEM-15/3420/RA3/WASH/INGO/1951,15084,14648,14642,14216,58590,51512,49779,69634,66955,237880
64,Yemen,1,2015,YEM-15/3420/RA3/FS/INGO/1957,1686,2343,2458,2613,9100,2151,2253,2361,2521,9286
64,Yemen,1,2015,YEM-15/3420/RA3/H/NGO/1958,4338,11888,10512,10912,37650,6384,18020,6761,7336,38501
64,Yemen,1,2015,YEM-15/3420/RA3/FS/UN/1961,5435,515,0,0,5950,5235,515,0,0,5750
64,Yemen,1,2015,YEM-15/3420/RA3/WASH/INGO/1973,21833,22859,3883,3103,51678,19282,19714,11090,10200,60286
64,Yemen,1,2015,YEM-15/3420/RA3/H/INGO/1982,8119,16885,6601,6870,38475,8021,14855,6311,6061,35248
64,Yemen,1,2015,YEM-15/3420/RA3/WASH/NGO/1983,1490,1550,6734,5326,15100,2031,1931,7648,15314,26924
64,Yemen,1,2015,YEM-15/3420/RA3/H/INGO/1991,30200,30200,25725,25726,111851,10032,9675,8548,8245,36500
64,Yemen,1,2015,YEM-15/3420/RA3/H/NGO/1995,6700,12420,7080,9800,36000,11599,22200,10660,12493,56952
64,Yemen,1,2015,YEM-15/3420/RA3/P/INGO/2002,5008,5032,5084,5084,20208,9653,3458,7075,6419,26605
64,Yemen,1,2015,YEM-15/3420/RA3/P/INGO/2006,1800,1800,3000,3000,9600,1904,2208,2114,2038,8264
64,Yemen,1,2015,YEM-15/3420/RA3/FS/NGO/2007,1680,2520,1330,1470,7000,1447,1713,1406,1337,5903
64,Yemen,1,2015,YEM-15/3420/RA3/FS/INGO/2008,3220,4200,2800,3780,14000,2807,3186,4981,4584,15558
64,Yemen,1,2015,YEM-15/3420/RA3/N/UN/2009,0,2000,2000,2000,6000,0,4066,2001,2327,8394
64,Yemen,1,2015,YEM-15/3420/RA3/WASH/UN/2015,20535,18315,7770,8880,55500,16964,15130,6419,7336,45849
64,Yemen,1,2015,YEM-15/3420/RA3/H/INGO/2016,963,412,0,0,1375,783,567,0,0,1350
64,Yemen,1,2015,YEM-15/3420/RA3/WASH/INGO/2027,5479,5413,5595,5027,21514,5138,4853,6313,6100,22404
64,Yemen,1,2015,YEM-15/3420/RA3/P/NGO/2037,320,1280,400,400,2400,0,1899,440,442,2781
64,Yemen,1,2015,YEM-15/3420/RA3/H/INGO/2038,1709,1637,300,290,3936,1966,864,210,199,3239
64,Yemen,1,2015,YEM-15/3420/RA3/FS/INGO/2041,2264,2356,4394,4573,13587,4071,4236,4237,4410,16954
64,Yemen,1,2015,YEM-15/3420/RA3/N/UN/2044,0,0,8254,7929,16183,0,0,10292,9888,20180
64,Yemen,1,2015,YEM-15/3420/RA4/FS/UN/2239,1900,1400,2000,1770,7070,1900,1400,2000,1770,7070
64,Yemen,1,2015,YEM-15/3420/RA4/L/UN/2252,9713,9715,9714,9715,38857,9713,9715,9714,9715,38857
64,Yemen,1,2015,YEM-15/3420/RA4/NFI/UN/2272,2940,4116,3234,4410,14700,2946,4124,3240,4418,14728
64,Yemen,1,2015,YEM-15/3420/RA4/WASH/UN/2274,71665,100331,78832,107498,358326,78614,110060,86476,117922,393072
64,Yemen,1,2015,YEM-15/3420/RA4/WASH/UN/2275,14820,14820,16055,16055,61750,14197,14197,15393,15393,59180
64,Yemen,1,2015,YEM-15/3420/RA4/H/UN/2277,134139,149345,187063,206295,676842,143858,166573,227573,219574,757578
64,Yemen,1,2015,YEM-15/3420/RA4/NFI/UN/2278,9551,9020,6643,6286,31500,7678,7510,8272,8040,31500
64,Yemen,1,2015,YEM-15/3420/RA4/FS/UN/2279,8000,8000,7200,6800,30000,9310,9690,9650,9350,38000
64,Yemen,1,2015,YEM-15/3420/RA4/H/UN/2281,5000,25000,0,0,30000,409,47453,0,0,47862
64,Yemen,1,2015,YEM-15/3420/RA4/H/UN/2284,25000,32000,130000,125000,312000,25000,116768,186993,171994,500755
64,Yemen,2,2016,YEM-16/3420/1SA 2016/SHNFICCM-WASH-FSAC/INGO/2800,5661,5661,5878,5445,22645,4725,4717,5856,5720,21018
64,Yemen,2,2016,YEM-16/3420/1SA 2016/Health/INGO/2802,11492,17316,17486,17202,63496,10100,21905,8241,17863,58109
64,Yemen,2,2016,YEM-16/3420/1SA 2016/Health/NGO/2805,10543,15790,9037,8695,44065,11018,11875,9416,16841,49150
64,Yemen,2,2016,YEM-16/3420/1SA 2016/WASH/INGO/2811,6641,6527,4787,4631,22586,6641,6527,4787,4631,22586
64,Yemen,2,2016,YEM-16/3420/1SA 2016/WASH-FSAC/NGO/2813,8234,8571,12352,12857,42014,19610,20345,26144,27662,93761
64,Yemen,2,2016,YEM-16/3420/1SA 2016/Health-Protection/NGO/2829,187,188,125,125,625,146,80,124,85,435
64,Yemen,2,2016,YEM-16/3420/1SA 2016/Protection/NGO/2830,2922,5047,3290,3393,14652,3025,4951,3659,3568,15203
64,Yemen,2,2016,YEM-16/3420/1SA 2016/SHNFICCM-WASH-FSAC/INGO/2842,3671,3830,4150,4309,15960,5331,5562,6026,6258,23177
64,Yemen,2,2016,YEM-16/3420/1SA 2016/Health/UN/2845,28000,140000,0,0,168000,19794,133060,0,0,152854
64,Yemen,2,2016,YEM-16/3420/1SA 2016/WASH-Health/INGO/2848,32657,42486,13701,13526,102370,34420,33292,23135,22007,112854
64,Yemen,2,2016,YEM-16/3420/1SA 2016/SHNFICCM/NGO/2850,4562,5064,7620,7822,25068,6000,5991,8550,8487,29028
64,Yemen,2,2016,YEM-16/3420/1SA 2016/Health/NGO/2852,8680,10340,9400,9430,37850,8950,27429,11055,10751,58185
64,Yemen,2,2016,YEM-16/3420/1SA 2016/Protection-CP/NGO/2857,2557,3342,1235,2220,9354,3149,5459,1532,3122,13262
64,Yemen,2,2016,YEM-16/3420/1SA 2016/SHNFICCM-FSAC/NGO/2867,2633,2528,2334,2242,9737,2139,2739,2774,2779,10431
64,Yemen,2,2016,YEM-16/3420/1SA 2016/SHNFICCM/NGO/2868,2160,2070,1914,1836,7980,1782,2033,2037,1837,7689
64,Yemen,2,2016,YEM-16/3420/1SA 2016/Protection-CP/NGO/2874,13239,14364,8472,8448,44523,12648,14007,16781,15792,59228
64,Yemen,2,2016,YEM-16/3420/1SA 2016/WASH/UN/2877,7300,10220,8030,10950,36500,8303,11623,9134,12454,41514
64,Yemen,2,2016,YEM-16/3420/1SA 2016/Health/INGO/2883,31278,46143,22959,26199,126579,49398,72875,36260,41377,199910
64,Yemen,2,2016,YEM-16/3420/1SA 2016/Protection/UN/2893,471529,525937,398985,417122,1813573,427448,452398,565311,546183,1991340
64,Yemen,2,2016,YEM-16/3420/1SA 2016/FSAC/UN/2894,2800,3100,7328,7772,21000,3080,3410,8060,8550,23100
64,Yemen,2,2016,YEM-16/3420/1SA 2016/Nutrition/INGO/2895,50,6488,5422,5645,17605,119,7099,9292,10021,26531
64,Yemen,2,2016,YEM-16/3420/1SA 2016/Health-Protection/NGO/2902,8033,7201,6093,6370,27697,4593,39634,15494,18313,78034
64,Yemen,2,2016,YEM-16/3420/1SA 2016/FSAC-SHNFICCM/INGO/2904,5000,5582,4238,4430,19250,3390,3569,3893,3447,14299
64,Yemen,2,2016,YEM-16/3420/1SA 2016/Nutrition/NGO/2905,128,4568,4640,4640,13976,133,5946,3245,3948,13272
64,Yemen,2,2016,YEM-16/3420/1SA 2016/WASH-FSAC-Nutrition/INGO/2909,10508,25192,10263,9865,55828,15573,18117,16987,16305,66982
64,Yemen,2,2016,YEM-16/3420/1SA 2016/WASH/UN/2915,18923,18195,18189,17478,72785,21176,21212,18080,15159,75627
64,Yemen,2,2016,YEM-16/3420/1SA 2016/Protection/UN/2917,369756,395759,306973,313086,1385574,341758,350471,427595,358234,1478058
64,Yemen,2,2016,YEM-16/3420/1SA 2016/FSAC/NGO/2920,2030,1820,1540,1610,7000,2123,2102,2210,2056,8491
64,Yemen,2,2016,YEM-16/3420/1SA 2016/SHNFICCM/NGO/2927,668,707,1182,1112,3669,1561,1693,2099,2087,7440
64,Yemen,2,2016,YEM-16/3420/1SA 2016/Protection-SHNFICCM/NGO/2946,100,700,100,300,1200,100,700,100,300,1200
64,Yemen,2,2016,YEM-16/3420/1SA 2016/WASH/INGO/2947,11874,11407,8698,8311,40290,10254,10339,10929,10508,42030
64,Yemen,2,2016,YEM-16/3420/1SA 2016/FSAC-WASH-Protection/INGO/2954,10574,11121,11880,12202,45777,10111,10570,36337,30701,87719
64,Yemen,2,2016,YEM-16/3420/1SA 2016/WASH-FSAC/INGO/2956,42626,41902,30738,29723,144989,53620,52709,38665,37389,182383
64,Yemen,2,2016,YEM-16/3420/1SA 2016/WASH-SHNFICCM/INGO/2957,15061,22920,13424,14080,65485,16526,18600,17123,18931,71180
64,Yemen,2,2016,YEM-16/3420/1SA 2016/Nutrition/UN/2959,0,0,4717,4533,9250,0,0,4717,4533,9250
64,Yemen,2,2016,YEM-16/3420/1SA 2016/Logistics/UN/2960,125,125,0,0,250,86,86,0,0,172
64,Yemen,2,2016,YEM-16/3420/1SA 2016/SHNFICCM/UN/2962,4480,6272,4928,6720,22400,4480,6272,4928,6720,22400
64,Yemen,2,2016,YEM-16/3420/2SA 2016/Health-Nutrition/INGO/4148,14306,35151,5445,6289,61191,5555,16295,10572,9801,42223
64,Yemen,2,2016,YEM-16/3420/2SA 2016/FSAC-WASH-SHNFICCM/INGO/4163,4313,4276,3704,3707,16000,8284,8893,12824,11162,41163
64,Yemen,2,2016,YEM-16/3420/2SA 2016/Health-WASH/NGO/4171,12496,22636,7800,8100,51032,11879,24861,10182,10624,57546
64,Yemen,2,2016,YEM-16/3420/2SA 2016/Nutrition-Health-WASH/INGO/4179,5037,9038,6000,6000,26075,6768,32889,8957,9441,58055
64,Yemen,2,2016,YEM-16/3420/2SA 2016/FSAC-SHNFICCM-WASH/INGO/4181,10063,10500,11375,11812,43750,8998,9432,10145,10621,39196
64,Yemen,2,2016,YEM-16/3420/2SA 2016/WASH/NGO/4192,7475,7840,7434,7251,30000,6615,6504,6437,5754,25310
64,Yemen,2,2016,YEM-16/3420/2SA 2016/Nutrition-WASH/INGO/4193,286,3920,3651,3390,11247,309,8199,5607,6026,20141
64,Yemen,2,2016,YEM-16/3420/2SA 2016/FSAC/UN/4201,44661,41353,38044,41353,165411,44661,41353,38044,41353,165411
64,Yemen,2,2016,YEM-16/3420/2SA 2016/WASH-SHNFICCM-FSAC/INGO/4204,2515,2617,5029,5235,15396,12103,13355,16812,18955,61225
64,Yemen,2,2016,YEM-16/3420/2SA 2016/SHNFICCM-WASH-FSAC/INGO/4209,8887,8886,9242,8531,35546,10750,10749,11180,10320,42999
64,Yemen,2,2016,YEM-16/3420/2SA 2016/Nutrition-FSAC-Health/INGO/4212,501,9510,22804,21886,54701,373,26038,28049,29930,84390
64,Yemen,2,2016,YEM-16/3420/2SA 2016/Health-Nutrition-WASH/NGO/4220,8200,29500,22850,21000,81550,9366,39185,33917,34949,117417
64,Yemen,2,2016,YEM-16/3420/2SA 2016/SHNFICCM/NGO/4226,4010,4962,8035,8797,25804,3590,4341,8780,9187,25898
64,Yemen,2,2016,YEM-16/3420/2SA 2016/FSAC/NGO/4232,1488,3883,1812,1788,8971,1499,4355,1806,1815,9475
64,Yemen,2,2016,YEM-16/3420/2SA 2016/Nutrition-Health/NGO/4235,7810,11690,12402,11925,43827,4398,8745,19542,18425,51110
64,Yemen,2,2016,YEM-16/3420/2SA 2016/Nutrition-FSAC/UN/4236,0,35579,62657,57837,156073,0,52644,58322,59879,170845
64,Yemen,2,2016,YEM-16/3420/2SA 2016/Health/UN/4238,36000,108000,0,0,144000,13084,133204,0,0,146288
64,Yemen,2,2016,YEM-16/3420/2SA 2016/WASH/NGO/4244,20215,21040,13477,14027,68759,31033,32300,20689,21533,105555
64,Yemen,2,2016,YEM-16/3420/2SA 2016/Health-Nutrition-WASH/NGO/4245,23310,26920,26158,26158,102546,20347,38642,24621,29426,113036
64,Yemen,2,2016,YEM-16/3420/2SA 2016/SHNFICCM/INGO/4248,2400,2400,6000,6000,16800,5053,5114,13382,13565,37114
64,Yemen,2,2016,YEM-16/3420/2SA 2016/Nutrition-Health/INGO/4255,6753,10278,1055,1019,19105,2210,11866,2531,4546,21153
64,Yemen,2,2016,YEM-16/3420/2SA 2016/Health/NGO/4259,14256,19483,7128,6653,47520,11351,51694,16895,17482,97422
64,Yemen,2,2016,YEM-16/3420/2SA 2016/Nutrition-FSAC-WASH/INGO/4263,6060,14168,10480,9868,40576,7544,9277,6739,6681,30241
64,Yemen,2,2016,YEM-16/3420/2SA 2016/WASH-FSAC/INGO/4265,16382,16107,11868,11483,55840,27853,27380,20085,19421,94739
64,Yemen,2,2016,YEM-16/3420/2SA 2016/FSAC/NGO/4267,2350,7540,2555,4213,16658,4429,3714,4334,5156,17633
64,Yemen,2,2016,YEM-16/3420/2SA 2016/Health-Nutrition/INGO/4272,29032,27482,28179,28027,112720,13078,81584,28540,32047,155249
64,Yemen,2,2016,YEM-16/3420/2SA 2016/Health-WASH-Nutrition/INGO/4276,18833,24046,21292,22667,86838,4817,7686,5095,4949,22547
64,Yemen,2,2016,YEM-16/3420/2SA 2016/Health-Nutrition/UN/4283,0,140000,399208,364852,904060,0,140000,399208,364852,904060
64,Yemen,1,2016,YEM-16/3420/1RA/WASH/INGO/4315,3780,4620,5670,6930,21000,6182,5297,9382,9645,30506
64,Yemen,1,2016,YEM-16/3420/1RA/WASH-Health/NGO/4317,27166,28274,18110,18850,92400,26516,23676,34338,32572,117102
64,Yemen,1,2016,YEM-16/3420/1RA/WASH/INGO/4318,5655,5410,6860,6615,24540,5596,5840,7651,7949,27036
64,Yemen,1,2016,YEM-16/3420/1RA/Health-WASH/INGO/4321,5501,6535,13315,14594,39945,6070,6820,15484,15664,44038
64,Yemen,1,2016,YEM-16/3420/1RA/WASH/INGO/4327,24682,24263,17798,17211,83954,164100,157961,87001,84058,493120
64,Yemen,1,2017,YEM-17/3420/RA1 2017/WASH-Health/NGO/4521,23819,23868,5939,5725,59351,18655,20043,23336,22492,84526
64,Yemen,1,2017,YEM-17/3420/RA1 2017/WASH/UN/4522,52836,50764,18564,17836,140000,52836,50764,18564,17836,140000
64,Yemen,1,2017,YEM-17/3420/RA1 2017/Health-WASH/INGO/4526,3268,3090,5110,4782,16250,3093,4241,4801,4241,16376
64,Yemen,1,2017,YEM-17/3420/RA1 2017/WASH/INGO/4530,9660,9240,11760,11340,42000,10939,11139,9882,10278,42238
64,Yemen,1,2017,YEM-17/3420/RA1 2017/WASH/INGO/4533,72905,72790,76350,70611,292656,74803,74756,77717,71739,299015
64,Yemen,1,2017,YEM-17/3420/RA1 2017/Health-WASH/NGO/4537,5513,5909,13513,13891,38826,13512,14142,18608,18881,65143
64,Yemen,2,2016,YEM-16/3420/2SA 2016/Health-Nutrition/INGO/4716,9960,14038,25220,25220,74438,33622,42099,17960,16592,110273
64,Yemen,2,2017,YEM-17/3420/1SA 2017/SHNFICCM-WASH/NGO/5834,2599,3073,4271,4175,14118,2598,3072,4270,4174,14114
64,Yemen,2,2017,YEM-17/3420/1SA 2017/Health-Nutrition-WASH-FSAC/INGO/5838,14558,14024,10591,9188,48361,0,0,0,0,0
64,Yemen,2,2017,YEM-17/3420/1SA 2017/WASH-FSAC-SHNFICCM/INGO/5861,7046,6752,7926,7634,29358,9631,8976,11682,12153,42442
64,Yemen,2,2017,YEM-17/3420/1SA 2017/Health-Nutrition-WASH/INGO/5887,10220,38554,19040,19580,87394,2213,5332,2710,2486,12741
64,Yemen,2,2017,YEM-17/3420/1SA 2017/Nutrition-Health/NGO/5933,20418,21250,4182,4352,50202,11585,26003,17996,17567,73151
64,Yemen,2,2017,YEM-17/3420/1SA 2017/FSAC/NGO/5953,2008,2426,1999,1914,8347,1400,1500,3152,3028,9080
64,Yemen,2,2017,YEM-17/3420/1SA 2017/Health-WASH/NGO/5977,23426,63139,30627,31032,148224,8240,23986,9693,9298,51217
64,Yemen,2,2017,YEM-17/3420/1SA 2017/FSAC-WASH/NGO/5982,3080,10780,770,770,15400,5190,5106,7630,7652,25578
64,Yemen,2,2017,YEM-17/3420/1SA 2017/WASH-Protection/UN/5995,149823,144256,67347,65034,426460,0,0,0,0,0
64,Yemen,2,2017,YEM-17/3420/1SA 2017/FSAC-Nutrition-WASH/NGO/5998,2234,3617,3585,3729,13165,4965,5188,4147,3852,18152
64,Yemen,2,2017,YEM-17/3420/1SA 2017/WASH-Health-Nutrition/NGO/5999,31822,37293,31723,34464,135302,14171,23364,19819,48649,106003
64,Yemen,2,2017,YEM-17/3420/1SA 2017/Health-Nutrition-WASH/INGO/6012,12328,12831,12831,13354,51344,2890,6983,7354,6804,24031
64,Yemen,2,2017,YEM-17/3420/1SA 2017/FSAC-Protection-SHNFICCM/NGO/6014,3200,3000,6660,6672,19532,5258,5123,7630,6437,24448
64,Yemen,2,2017,YEM-17/3420/1SA 2017/FSAC/NGO/6016,3542,3703,4348,4507,16100,5824,6891,8078,8215,29008
64,Yemen,2,2017,YEM-17/3420/1SA 2017/FSAC-WASH/INGO/6019,11055,11780,7915,10467,41217,2877,2943,3242,3374,12436
64,Yemen,2,2017,YEM-17/3420/1SA 2017/SHNFICCM-WASH/INGO/6020,2949,3069,3069,3194,12281,1356,1451,1753,1870,6430
64,Yemen,2,2017,YEM-17/3420/1SA 2017/FSAC/NGO/6025,2998,3120,614,639,7371,5730,5964,1173,1224,14091
64,Yemen,2,2017,YEM-17/3420/1SA 2017/Health/UN/6069,1900,2200,3000,2900,10000,2375,2750,3750,3625,12500
64,Yemen,2,2017,YEM-17/3420/1SA 2017/WASH/NGO/6096,4379,5846,4373,5402,20000,5268,7033,5260,6499,24060
64,Yemen,2,2017,YEM-17/3420/1SA 2017/WASH-FSAC/NGO/6107,6884,7191,9538,10073,33686,1834,1057,2561,4359,9811
64,Yemen,2,2017,YEM-17/3420/1SA 2017/WASH/INGO/6114,9992,9736,16140,15372,51240,0,0,0,0,0
64,Yemen,2,2017,YEM-17/3420/1SA 2017/FSAC-WASH/INGO/6116,13724,13202,9686,9259,45871,0,0,0,0,0
64,Yemen,2,2017,YEM-17/3420/1SA 2017/Health/UN/6120,17000,78125,1125,1125,97375,3363,100701,0,0,104064
64,Yemen,2,2017,YEM-17/3420/1SA 2017/FSAC/NGO/6132,2230,2321,3344,3481,11376,4932,5513,6343,5860,22648
64,Yemen,2,2017,YEM-17/3420/1SA 2017/WASH/NGO/6137,2011,2058,2767,2878,9714,2332,2428,3499,3641,11900
64,Yemen,2,2017,YEM-17/3420/1SA 2017/Health/NGO/6138,15254,15876,22808,23760,77698,21333,20302,23173,36027,100835
64,Yemen,2,2017,YEM-17/3420/1SA 2017/Nutrition-FSAC-WASH/INGO/6140,9611,9234,2167,2082,23094,0,0,0,0,0
64,Yemen,2,2017,YEM-17/3420/1SA 2017/Nutrition-Health-WASH/NGO/6142,9764,13018,19527,22782,65091,7412,42220,20095,35075,104802
64,Yemen,2,2017,YEM-17/3420/1SA 2017/Nutrition/INGO/6159,61,15975,5339,4733,26108,47,3238,2230,2158,7673
64,Yemen,2,2017,YEM-17/3420/1SA 2017/WASH-FSAC-Nutrition/NGO/6163,1788,2953,674,647,6062,2067,3307,827,689,6890
64,Yemen,2,2017,YEM-17/3420/1SA 2017/SHNFICCM/NGO/6164,540,514,662,710,2426,588,618,599,621,2426
64,Yemen,2,2017,YEM-17/3420/1SA 2017/Health-Nutrition/INGO/6165,29297,27649,29462,28232,114640,2943,11515,6186,5670,26314
64,Yemen,2,2017,YEM-17/3420/1SA 2017/FSAC-WASH/INGO/6166,11284,10516,14668,13932,50400,14875,15668,13104,14590,58237
64,Yemen,2,2017,YEM-17/3420/1SA 2017/WASH-Health-SHNFICCM-Protection/NGO/6172,7477,8159,4065,4749,24450,7545,9815,12862,14413,44635
64,Yemen,1,2017,YEM-17/3420/2RA 2017/Health-WASH/INGO/6258,12800,13200,6800,7200,40000,1479,1850,4208,3167,10704
64,Yemen,1,2017,YEM-17/3420/2RA 2017/Health/INGO/6261,39123,37259,38076,37942,152400,54583,83357,0,0,137940
64,Yemen,1,2017,YEM-17/3420/2RA 2017/Health-WASH/NGO/6262,45208,47053,9259,9637,111157,45386,39358,35602,29227,149573
64,Yemen,1,2017,YEM-17/3420/2RA 2017/WASH/NGO/6263,8232,8568,12348,12852,42000,13750,13857,18502,18301,64410
64,Yemen,1,2017,YEM-17/3420/2RA 2017/Health-WASH/INGO/6264,10150,10500,7000,7350,35000,7308,7698,6082,5989,27077
64,Yemen,1,2017,YEM-17/3420/2RA 2017/Health-WASH/NGO/6265,15233,30462,17765,18469,81929,20007,37908,23166,24219,105300
64,Yemen,1,2017,YEM-17/3420/2RA 2017/Health-WASH/NGO/6267,13972,14976,34247,35205,98400,35205,31558,34835,30843,132441
64,Yemen,1,2017,YEM-17/3420/2RA 2017/WASH/INGO/6268,12600,15400,18900,23100,70000,18877,20002,22639,21407,82925
64,Yemen,1,2017,YEM-17/3420/2RA 2017/WASH/NGO/6269,25444,30369,12312,13955,82080,22369,30129,11378,16913,80789
64,Yemen,1,2017,YEM-17/3420/2RA 2017/WASH/NGO/6270,8528,8431,25601,25306,67866,15554,15760,19398,19917,70629
64,Yemen,1,2017,YEM-17/3420/2RA 2017/Health-WASH/NGO/6271,8208,8892,8311,8789,34200,12750,14250,13800,15200,56000
64,Yemen,1,2017,YEM-17/3420/2RA 2017/WASH/INGO/6272,55087,52927,67328,64688,240030,39580,38027,48375,46478,172460
64,Yemen,1,2017,YEM-17/3420/2RA 2017/WASH/UN/6275,105672,101528,37128,35672,280000,105672,101528,37128,39172,283500
64,Yemen,1,2017,YEM-17/3420/2RA 2017/Health/NGO/6276,6000,6000,7200,7026,26226,9832,19127,14673,17475,61107
64,Yemen,1,2017,YEM-17/3420/2RA 2017/Health-WASH/INGO/6277,8003,8330,16007,16660,49000,12998,13877,15508,15092,57475
64,Yemen,1,2017,YEM-17/3420/2RA 2017/WASH/INGO/6279,13230,13005,9540,9225,45000,18384,18007,17485,16976,70852
64,Yemen,1,2017,YEM-17/3420/2RA 2017/Health-WASH/INGO/6280,15547,15180,15908,14875,61510,10797,9037,10296,8135,38265
64,Yemen,1,2017,YEM-17/3420/2RA 2017/WASH/INGO/6282,7245,6930,8820,8505,31500,10121,10525,9340,9718,39704
64,Yemen,1,2017,YEM-17/3420/3RA 2017/Logistics/UN/6303,1210,623,0,0,1833,1732,892,0,0,2624
64,Yemen,1,2017,YEM-17/3420/3RA 2017/SHNFICCM/UN/6308,2100,3150,2100,3150,10500,1431,2800,1700,2800,8731
64,Yemen,2,2017,YEM-17/3420/2SA 2017/Nutrition-Health-FSAC/NGO/6926,9694,10089,14495,15100,49378,13871,21089,6839,8557,50356
64,Yemen,2,2017,YEM-17/3420/2SA 2017/WASH/NGO/6934,6005,5830,7680,7988,27503,4042,3782,4073,4206,16103
64,Yemen,2,2017,YEM-17/3420/2SA 2017/Nutrition-FSAC/NGO/6947,11949,12427,2689,2808,29873,2747,3811,1935,2004,10497
64,Yemen,2,2017,YEM-17/3420/2SA 2017/Nutrition-Protection-Health/INGO/6966,25242,26272,12433,12940,76887,3340,7671,7538,7422,25971
64,Yemen,2,2017,YEM-17/3420/2SA 2017/Health-WASH-SHNFICCM/NGO/6969,11865,22735,10950,13900,59450,7133,18988,8719,9120,43960
64,Yemen,2,2017,YEM-17/3420/2SA 2017/FSAC-WASH-SHNFICCM-Protection/INGO/6970,6317,7721,9476,11581,35095,4620,4860,7348,7165,23993
64,Yemen,2,2017,YEM-17/3420/2SA 2017/WASH/INGO/6974,4000,5000,7500,7500,24000,3922,3790,2976,2840,13528
64,Yemen,2,2017,YEM-17/3420/2SA 2017/FSAC-WASH/NGO/6975,16635,19070,17769,17926,71400,1344,1456,1512,1288,5600
64,Yemen,2,2017,YEM-17/3420/2SA 2017/FSAC/NGO/6979,8541,8889,1749,1821,21000,3938,4107,3526,3142,14713
64,Yemen,2,2017,YEM-17/3420/2SA 2017/WASH-FSAC/NGO/6981,4650,4536,4623,4191,18000,4030,4891,6080,5850,20851
64,Yemen,2,2017,YEM-17/3420/2SA 2017/WASH-FSAC/INGO/6983,24712,23536,35303,34126,117677,16132,15499,22278,21404,75313
64,Yemen,2,2017,YEM-17/3420/2SA 2017/FSAC-WASH-Health/NGO/6990,7013,7299,10519,10958,35789,4449,5619,5870,5342,21280
64,Yemen,2,2017,YEM-17/3420/2SA 2017/Health-Nutrition/NGO/6998,16098,52146,6369,6629,81242,4370,13762,5161,5522,28815
64,Yemen,2,2017,YEM-17/3420/2SA 2017/FSAC/UN/7002,3650,3080,3990,3280,14000,0,0,0,0,0
64,Yemen,2,2017,YEM-17/3420/2SA 2017/Protection/INGO/7007,3586,8014,2214,2214,16028,39,189,20,36,284
64,Yemen,2,2017,YEM-17/3420/2SA 2017/WASH-FSAC-Health-Nutrition/INGO/7008,11615,11317,18752,17859,59543,0,0,0,0,0
64,Yemen,2,2017,YEM-17/3420/2SA 2017/FSAC-WASH/NGO/7014,5600,19600,1400,1400,28000,0,0,0,0,0
64,Yemen,2,2017,YEM-17/3420/2SA 2017/Protection-SHNFICCM/NGO/7015,14056,7667,8092,12778,42593,4866,5053,6639,6238,22796
64,Yemen,2,2017,YEM-17/3420/2SA 2017/FSAC-Health-Nutrition/INGO/7017,6771,8983,7209,6927,29890,8,14,0,0,22
64,Yemen,2,2017,YEM-17/3420/2SA 2017/FSAC/NGO/7018,7489,8601,7446,7964,31500,8723,10026,8651,9231,36631
64,Yemen,2,2017,YEM-17/3420/2SA 2017/SHNFICCM-Protection-WASH/NGO/7023,7683,7287,4230,4523,23723,0,0,0,0,0
64,Yemen,2,2017,YEM-17/3420/2SA 2017/Health-WASH/NGO/7024,39873,41501,15595,16233,113202,26090,33301,59648,55291,174330
64,Yemen,2,2017,YEM-17/3420/2SA 2017/FSAC-Protection/NGO/7035,9911,10363,12165,12611,45050,8479,15003,10552,10784,44818
64,Yemen,2,2017,YEM-17/3420/2SA 2017/SHNFICCM-WASH/NGO/7042,4446,5291,9171,9465,28373,4429,5229,9372,9659,28689
64,Yemen,2,2017,YEM-17/3420/2SA 2017/SHNFICCM-WASH/NGO/7043,466,485,547,631,2129,1284,1061,798,687,3830
64,Yemen,2,2017,YEM-17/3420/2SA 2017/FSAC-Health/NGO/7044,6106,12420,6200,6333,31059,6538,12357,7037,6538,32470
64,Yemen,2,2017,YEM-17/3420/2SA 2017/FSAC/NGO/7061,5762,5998,8644,8996,29400,0,0,0,0,0
64,Yemen,2,2017,YEM-17/3420/2SA 2017/Health-WASH-Nutrition/NGO/7067,12463,20250,16053,15760,64526,7886,8105,6827,7615,30433
64,Yemen,2,2017,YEM-17/3420/2SA 2017/WASH/NGO/7076,17600,17600,6400,6400,48000,6799,6933,1729,1791,17252
64,Yemen,2,2017,YEM-17/3420/2SA 2017/Health/NGO/7079,10000,20000,10000,10000,50000,21603,38126,23196,24653,107578
64,Yemen,2,2017,YEM-17/3420/2SA 2017/Health-WASH/NGO/7080,12387,12502,13659,20040,58588,12753,15846,19016,19884,67499
64,Yemen,2,2017,YEM-17/3420/2SA 2017/WASH-Protection/NGO/7088,2461,2575,2475,2520,10031,2639,4084,3090,2522,12335
64,Yemen,2,2017,YEM-17/3420/2SA 2017/Nutrition-Health/O/7098,46072,76546,78268,72487,273373,10961,74345,55050,58376,198732
64,Yemen,2,2017,YEM-17/3420/2SA 2017/WASH-FSAC/INGO/7103,5820,5829,6966,6585,25200,5866,5967,5814,5402,23049
64,Yemen,2,2017,YEM-17/3420/2SA 2017/FSAC-WASH/INGO/7105,4320,4080,7920,7680,24000,80,77,147,142,446
64,Yemen,2,2017,YEM-17/3420/2SA 2017/FSAC-Health/NGO/7118,6090,9983,3990,4410,24473,8215,11801,6983,6289,33288
64,Yemen,2,2017,YEM-17/3420/2SA 2017/FSAC/NGO/7121,5355,5145,5355,5145,21000,1785,1715,1785,1715,7000
64,Yemen,2,2017,YEM-17/3420/2SA 2017/Health-WASH/NGO/7130,12230,11290,18346,16934,58800,14383,17029,13820,12110,57342
64,Yemen,2,2017,YEM-17/3420/2SA 2017/Nutrition-WASH/UN/7135,0,0,15300,14700,30000,0,0,5890,6130,12020
64,Yemen,2,2017,YEM-17/3420/2SA 2017/Health/NGO/7150,3000,2000,2050,2950,10000,19094,21620,12679,12471,65864
64,Yemen,2,2017,YEM-17/3420/2SA 2017/FSAC/INGO/7158,2205,2205,2744,2646,9800,0,0,0,0,0
64,Yemen,2,2017,YEM-17/3420/2SA 2017/SHNFICCM/NGO/7161,1521,997,946,1786,5250,1046,1187,1402,1245,4880
64,Yemen,2,2017,YEM-17/3420/2SA 2017/Protection/NGO/7164,20770,12730,14070,19430,67000,6784,6720,7112,6694,27310
64,Yemen,2,2017,YEM-17/3420/2SA 2017/Protection/NGO/7168,3079,4460,3605,3730,14874,59,49,0,19,127
64,Yemen,2,2017,YEM-17/3420/2SA 2017/Protection/NGO/7169,1949,1277,1277,2217,6720,1849,2203,1735,1640,7427
64,Yemen,1,2018,YEM-18/3420/RA1-2018/FSAC/UN/9514,253000,264000,286000,297000,1100000,137383,143356,155302,161276,597317
64,Yemen,1,2018,YEM-18/3420/RA1-2018/SHNFICCM/NGO/9520,49,49,49,49,196,0,0,0,0,0
64,Yemen,1,2018,YEM-18/3420/RA1-2018/WASH/UN/9523,401916,386155,141214,135676,1064961,721125,254181,244213,695059,1914578
64,Yemen,1,2018,YEM-18/3420/RA1-2018/Health/NGO/9527,24864,26936,23828,27972,103600,12432,13468,11914,13986,51800
64,Yemen,1,2018,YEM-18/3420/RA1-2018/Health-Nutrition/NGO/9538,27974,29209,27828,27041,112052,26396,19838,16028,13444,75706
64,Yemen,1,2018,YEM-18/3420/RA1-2018/Protection/INGO/9540,37936,23250,24474,36712,122372,0,0,0,0,0
64,Yemen,1,2018,YEM-18/3420/RA1-2018/Health/NGO/9554,3645,5467,2733,6378,18223,0,0,0,0,0
64,Yemen,1,2018,YEM-18/3420/RA1-2018/FSAC/UN/9557,54873,63315,147735,156177,422100,0,0,0,0,0
64,Yemen,1,2018,YEM-18/3420/RA1-2018/Health/O/9558,11467,17912,11592,13259,54230,4994,19633,7895,9268,41790
64,Yemen,1,2018,YEM-18/3420/RA1-2018/MSREFMIG/UN/9559,800,1200,1200,1800,5000,480,720,720,1080,3000
64,Yemen,1,2018,YEM-18/3420/RA1-2018/Health/NGO/9561,12511,16086,14895,16085,59577,9356,12030,11138,12030,44554
64,Yemen,1,2018,YEM-18/3420/RA1-2018/Health/NGO/9564,1790,5368,895,895,8948,0,0,0,0,0
64,Yemen,1,2018,YEM-18/3420/RA1-2018/Protection/NGO/9568,19508,18743,3442,3307,45000,13356,14057,4665,4429,36507
64,Yemen,1,2018,YEM-18/3420/RA1-2018/Nutrition/UN/9573,0,0,10780,11220,22000,0,0,0,0,0
